SSSSSSSS--------
---------ooXX---
----------------
SSSS--------XXXX
----------------
----------------
-----SSSo-------
----------------
SSSS--------oooo
------------XXXX
-----------SSSSS
-------ooooSSSSS
------oXXXXSSSSS
----Xo----------
