----XXXX--####--
----XXXX--####--
----XXXX-TT#####
----XXXX--####--
----oooo--#XXX--
----XXXXT-#XXX--
----------#XXX--
----------#ooo--
---------TTXXX--
-------H--------
----------------
---XX##--TTX----
---XX##---#XXX--
-XXXX##---#XXX--
