--------SSS#####
------------####
--ooo--------###
-------------###
--------------D#
--------------D#
---------oo#####
------------TTTT
------XXXTTTTT--
----------------
---D###--TTT----
---D##D---####--
-TTT##D---####--
---#####--####--
