----------------
---------SSS----
----------------
X-----------XXXX
X--------------<
X--------------[
XXXXXSSSS------[
XX-------------[
XX--------XXXXXX
#D-------------#
#D-------------#
TTTT#oooo###--D#
--TTTXXXXT----D#
---------TTTTTTT
