----------------
----------------
------?SS-------
----------------
----------------
----oXXX--------
----------SSS---
----------------
----------------
--------TToo----
----------------
--SSSSTTTT------
----------------
----------------
