----------------
-----T--#--#----
----------------
----------------
-------------#--
-------------#--
-------------#--
--DTTQ--Q--#-#--
--D--#--#--#----
--#--#--#--#----
TT#--#--#--T----
----------------
----------------
########--------
