----####----####
################
####---#####-###
#------------T##
#-------------##
#------T---#--D#
#---HHHHH#######
#--######MM#TTTT
##-#------------
##-#------------
#------Q-------#
#-T------------#
#--------------#
#------E-------#
