---#------------
###-----------##
#######TT#----##
##------------##
##------------##
##----##########
##------------##
##------------##
##TT####------##
##----#####---##
##------------##
##------------##
#####-------####
#######TTTT#####
