##-----------###
-#######H--####-
-####------####-
-####------####-
-####----######-
#D----------####
##----------####
########H---####
####------######
####------####--
####H-H#######--
####------####--
##-----------###
##--TT-------###
