####----------##
--------------##
--------------##
-----------#####
----TTT##-------
----------------
####----------XX
-------------XXX
-------------XXX
-----------T-###
-------#HHHHHH##
-----T-######-#-
----------------
----------------
