#####---------D#
#-------------D#
#-------------##
####-------#####
####MMMMM###MM##
#--------------#
#--------------#
#---####-------#
#--------------#
----------------
#MMMM#######MMM#
#--------------#
#H-----------H##
#MMMM#######MMM#
