####T-----------
--##------------
--##TTT---------
-----D#---------
-----###D#------
--------D#------
--------#####---
-----------##---
####-------#####
--##-----------#
--#####--------#
-----##--------#
-----#####-----#
---------##----#
