#---###T-------#
#--------------#
----------------
#MMM###TTTTMMMM#
#--------------#
#H-----------H##
###########MMMM#
----------------
----------------
#----##-------##
#TT--##----#####
#---H##-------##
#----##-------##
#--TT--######--#
