-#######T--####-
-####------####-
-####------####-
-####----######-
##----------####
##----------####
####MMMMM---####
####------D#####
####------D###--
####T-TTT#####--
####------####--
##-----------###
##--TT-------###
##-----------D##
