####------------
####------------
########--------
######-#T-------
----------------
----------------
--------TTT#----
----------------
#-------------##
#-------------##
###H-------H####
#MMM#######MMM##
#--------------#
#--------------#
