EooXX###-------X
XXXX---#XXX----X
---------------X
-----------XH--#
---------------#
---------------#
-------------H##
---------------E
------XXXXXXXXXX
------XX--------
------XX--------
XXXXXXXX----XXXX
----------------
----------------
