----------------
--------X-------
----------------
--------T-------
----------------
----------------
X-----TTTX-XXXXX
X---------------
X---------------
X----------D#---
X----------D#--#
X-----###XX###-#
X-----##-------#
X--XX###-------#
