----XXXX----####
XXXXXXXXXXXX####
XXXX---XXXXX-###
X------------T##
X-------------##
#------X---#--D#
#---XXXXX#######
#--#XXXXXMM#TTTT
##-#------------
##-#------------
#------Q-------X
#-T------------X
#--------------X
#------E-------X
