-----Eo--------X
-----XX###-----X
---------##----X
---------XX----#
---------------#
------------####
------------##--
---------XXXXX--
---------XX-----
------###-------
------##--------
---#####--------
---##-----------
---##-----------
