---#------------
###-----------XX
####XXXXXX----XX
XX------------XX
XX------------XX
##----XXXXXXXXXX
##------------XX
##------------XX
##TT###X------XX
##----#XXXX---##
##------------##
##------------##
#####-------####
#######XXXX#####
