----------------
-----X--#--#----
----------------
----------------
-------------#--
-------------#--
-------------#--
--XXXX--X--#-#--
--X--#--#--#----
--#--#--#--#----
TT#--#--#--T----
----------------
----------------
########--------
