--------###X----
--------###X----
------#####X----
----------------
---###X---------
---##-----------
XX###-----XXXXXX
----------XX----
-------XXXXX----
----------------
----XXXX--------
----------------
----------------
--X-------------
