----------------
-----XX--XX-----
----------------
----------------
--XX------------
--SSSSX---------
-----XX---------
-----XXX[]------
--------XX------
--------XX###---
-----------##---
XXXX-------#####
--XX-----------#
--XXXXX--------#
