XX##TT-XX-----XX
XX##---XX-----XX
------T---XX----
----------------
----------------
-----TTXXX------
----------------
----------------
---TTTT--XXXX---
----------------
----------------
-------XX--XXXX-
----------------
----------------
