-----oo--XX-----
----------------
----------------
------X---XX----
----------------
----------------
-----XXXX?------
----------------
----------------
---XXXX--XXTT---
----------------
----------------
-------XX--TTTT-
----------------
