XX-X-----------X
X--XXXXX-------X
X--X-----------X
X-XX-----XX##--#
X--X-----------#
X--X----------##
XX-X----------##
X--X----------XX
X--X---XXXXXXXXX
--##---[X-------
---#---[X-------
---#-SS[X-------
####---[X-----XX
####---[X---XXXX
