TTTTXXXX--------
---------TT##---
----------------
?SSS--------TTTT
----------------
----------------
-----XXXX-------
----------------
####--------Eooo
------------XXXX
-----------SSSSS
-------ooooSSSSS
------oSSSSSSSSS
----So----------
