----------------
---T------------
----------------
----------------
----TXXo--------
----------TTT---
----------------
----------------
--------XXTT----
----------------
--TMMMMMXX------
----------------
----------------
TTT#------------
