----##----------
----##----------
TTTTT#-------###
------------##--
------STTT--<>--
------------[]--
------------[]--
----------SX##--
----------------
---E---#--------
XXXXX###MMMMMMMM
----------------
----------------
-------#T-------
