TTXX------------
----------------
----------------
------XXX-------
----------------
----------------
----MMMM--------
----------XXX---
----------------
----------------
--------##XX----
----------------
--SSMMMM##------
----------------
