------TTT-------
---D###--T##----
---D###---####--
-TTT###---####--
---#####--####--
----####--####--
----####--####--
----####-#######
----####--####--
----####--####--
----##TTT-####--
----------####--
----------####--
---------TTT##--
