######------####
####--------####
####--------####
##----##########
##------------##
##------------##
#####---#-----##
###D--------TT##
###D--------####
#######-----####
####--------####
##------------##
##-----TT##---D#
##------------D#
