-------T--------
----------------
---------#######
----------------
------####------
----------------
---####---------
--------------H-
####--------####
----------------
---------T###---
----------------
------TT##------
----------------
