XXXXX---------XX
X-------------XX
X-------------XX
####-------XXXXX
####MMMMMXXXMM##
#--------------#
#--------------#
#---####-------#
#--------------#
----------------
#MMMM#######MMM#
#--------------#
#H-----------H##
#MMMM#######MMM#
