-------##XX-----
---XHHH---------
---####---------
---#------------
####---------XXX
----------------
-----------TXXX-
-------XX##-----
-------####-----
----Eoo#--------
XXXXXXX#-------<
---------------[
---------------[
-------------SS[
