MMXX-----------X
---------XXXX--X
H#-------XX---XX
MM----XXXXX---X-
XX------------X-
XXTTT---------#-
--------------##
---TTXX-------##
-----XX-------##
-----XXTTT----XX
----------------
----------------
---------TTSS---
----------------
