####------------
####XXXX--------
#---XXXXXXX#----
#-------XXX#####
X-----------####
X-------------XX
X-------------XX
X---XXXX------XX
X---XXXXXXXX--XX
##------TT######
#D----------####
#D-----------###
####XXXTTT---###
####-----------#
