----------------
-----XXXXXXX----
----------------
----------------
---XXXX--XXXX---
----------------
----------------
------XXXX------
----------------
----------TToo--
----------------
----------------
---------TTTXXXX
----------------
