----------------
----------------
XXXXXXXXXXXXSSSS
X--------------X
X----X---------E
X--------------X
----------------
---X------------
----------------
##HHHEooo--#####
-####XXXX--#####
---------T-----#
---------------#
----------------
