XXXXT-----------
--XX------------
--XXTTT---------
-----oo---------
-----XXXXX------
--------XX------
--------XXXXX---
-----------XX---
XXXX-------XXXXX
--XX-----------X
--XX###--------X
-----##--------X
-----####X-----X
---------XX----X
