XXXXXX?X----XXXX
------------XXXX
------------####
------XXXXX#####
------[#--------
------[#--------
XXXXXSX#----XXXX
----------------
---------TTXX---
----------------
------####------
------##--------
---#####--------
---##-----------
