X------XXX#----#
XX-----XXX#--T-#
XXX----XXX#----#
##----XX-------#
##TT--XX-----T-#
------XX-------#
-----XXX-------#
-------X----XX--
---XX--X--------
-------#--------
#----##-------##
#TT--##----#####
#---H##D------##
#----##D------##
