----------#-----
----------------
----------------
XX----------####
XX----------####
XXXXXXXXX---####
XXXX------XX####
XXXX------XX##--
####X-XXXXXX##--
####------XX##--
##-----------###
##--XX-------###
##-----------D##
##-----------D##
