XXXX----------XX
--------------XX
--------------XX
-----------XXXXX
----XXXXX-------
----------------
XXXX----------XX
-------------XXX
-------------XXX
-----------T-###
-------#HHHHHH##
-----X-######-#-
----------------
----------------
