-------------###
-----------T-###
-------XXXXHHH##
-----X-XXXX##-#-
----------------
----------------
XXXX------------
XXXX------------
XXXXXXXX--------
XXXXXX-Xo-------
----------------
----------------
--------XXXX----
----------------
