##-----------XSS
-####XXXH--#XXX-
-####------#XXX-
-####------E###-
-####----XXX###-
#D----------####
XX----------####
XXXXXXXXX---####
####------XX####
####------####--
####H-H#######--
####------####--
##-----------###
##--TT-------###
