####------------
####------------
####XXXX--------
####XX-Xo-------
----------------
----------------
--------XXXX----
----------------
X-------------##
#-------------##
###H-------H####
#MMMXXXXXXXMMM##
#--------------#
#--------------#
