---------------#
X-----------####
X---XXXXXXX#####
X-------------##
X-------------##
XXXX----------##
XXEoooXX------##
XXXXXXXXXXX#--##
XX------------##
XX-----------###
XX-----------###
XX-----------###
XXXXXXXXXXXX####
XXXXXXXXXXXX####
