XX-----------###
XX-----------###
-XXXSSSXX--X###-
-XXXX------X###-
-XXXS------X###-
-XXQQ----######-
----------------
----------------
-------XX######-
-ooXX-----------
----------------
----------------
----XXXX--------
----------------
