X---XXXX-------B
X--------------b
----------------
#MMMXXXXXXXXXXXX
#--------------#
#H-----------H##
XXXXXXXXXXXMMMM#
----------------
----------------
#----##-------##
#TT--##----#####
#---H##-------##
#----##-------##
#--TT--######--#
