X--SS--EXXXXE--X
X------SXXX----X
XX-----Sooo--T-#
##H----SXXX----#
##----XX-------#
##TT--XX-----T-#
------XX-------#
-----XT#-------#
-------#----TT--
---XX--#--------
-------#--------
------------T---
----XT---XX-----
----------------
