----------------
---------XXXX---
----------------
----------------
ooMMMMXXXXXXXXXX
----------------
----------------
-X###-----------
----------------
----------------
-------XX-------
----------------
----------------
-----------XXXX-
