-------X--------
----------------
---------XXXXXXX
----------------
------XXXX------
----------------
---XXXX---------
--------------E-
XXXX--------XXXX
----------------
---------XXXX---
----------------
------XXXX------
----------------
