----------------
-----XX---------
----------------
---H-----E------
XXMMMMMXXXXMMMMM
----------------
--H--------#----
XXXXXXXXXXXXXXXX
----------------
----------------
---------X------
----------------
-----X----------
-----------X----
