-----------XXXX-
----------------
----------------
-XXXXXXXX-------
----------------
----------------
XXXX--------XXXX
XXXX--------XXXX
XXXXXXX-----XXXX
###Q--------####
##------------##
#D-----XXX#---D#
#D------------D#
###X--------####
