-----XX---------
----------------
---X-----X------
XXXXXXXXXXXX####
----------------
--X--------E----
XXXXXXXXXXXX####
----------------
----------------
###MMM######XXXX
----------------
----H--------E--
###MMM######XXXX
----------------
