----------TTTTTT
-------####-----
-------TTTT-----
---------------#
-XXXX--------###
XX----------XXXX
----------------
------XXXX------
XXXXXXXX--------
----------------
------------####
----------------
--------XXXXTTTT
----------------
