----------------
---X------------
-XXXX-----------
----------------
----------------
####------------
####------------
####--XXXX------
####------------
##-------------#
XX----------TTTT
XX-------------#
XX-------------#
XXXXXXXXXXX-----
