----------------
--------XXX-----
----------------
----------------
XXX---------XXXX
----------------
------------XXXX
XXSS------------
----------------
--XXXXXXXX------
----------------
----------------
------------XXXX
XXXX------------
