----------------
----------------
----XXXX--------
----------XXX---
----------------
----------------
--------XXXX----
----------------
--MMMMMXXX------
----------------
----------------
XX##------------
----------------
----------------
