---###X---------
----------------
----------------
XXX###X---------
----------------
------XXXX------
----------------
---------XXXX---
----------------
XXXX--------XXXX
-----o----------
----XXT---------
----------------
------TTXX------
