XXMMMXXX-----XXX
X----XXXXX--XXXX
X--H#XXXo--####-
X-MMMXXXXX----##
X-------------##
X-------------D#
X-------------D#
]-X---------####
]-X-----####----
XXXXXXXX--##TTTT
----------------
---------------X
-XXXXXXXX----XXX
------------XXXX
