SSSS----------<>
--------------[]
--------------[]
-----------XXXXX
----ooooo-------
----------------
SSSS----------EX
-------------<>X
-------------[]X
-----------S-###
-------ooooSHH##
-----o-SSSSS#-#-
----------------
----------------
