##-----------XSS
-####SSS#--DXXX-
-###D------DXXX-
-#HHH------E###-
-####----SSS###-
HH----------####
XX----------####
XXXXSSSSX---####
####------XX####
####------####--
####H-H#######--
####------####--
##-----------###
##--TT-------###
