XXXXo---------XX
X-------------XX
X-------------[]
####-------XXXXX
####SSSSSSSSMM##
#--------------#
#--------------#
D---oooo-------#
#--------------#
----------------
#MMMMSSSSSS?TTTT
#--------------#
#H-----------##T
#MMMMSSSoooo####
