X------<[]#----#
XX-----[[]#--T-#
XXX----[XX#----#
##----XX-------#
##TT--<>-----T-#
------[]-------#
-----XXX-------#
-------[----oo--
---oE--[--------
-------#--------
#----##-------##
###--##----#####
#---H##D------##
#----##D------##
