-XXXXXXXE--XXXX-
-XXXX------XXXX-
-###X------####-
-###X----oo####-
##----------####
##----------####
####XXXXX---####
XXXX------<SSSSS
XXXX------[SSS--
XXXXX-XXXXXSSS--
XSSS------####--
XX-----------###
XS--oo-------###
XX-----------###
