ooXX-----------X
---------XXEE--X
SS-------XX---XS
SS----XXXXX---X-
XX------------X-
oo###---------#-
--------------##
---TTXX-------##
-----XX-------##
-----ooTTT----XX
----------------
----------------
---------TTSS---
----------------
