X--SS--EXXXXE--X
X------SXXX----X
XX-----Sooo--Q-E
##H----SXXX----E
##----[]-------#
##TT--[]-----T-#
------XX-------#
-----o##-------#
-------#----TT--
---SS--#--------
-------#--------
------------T---
----oT---oo-----
----------------
