---------------#
X-----------####
X---XXSSSSS#####
X-------------##
X-------------##
XXXX----------##
XXooooXX------##
XXXXXXXXSSS#--##
XX------------##
XX-----------###
XX-----------###
XX-----------###
XXooooXXoooo####
XXXXXXXXXXXX####
