---------oo----#
---------------#
X-----------TTTT
X---XXXXXooSSSSS
X-------------SS
X-------------SS
XXXS----------SS
XXXSoooo------##
XXXSSXXXXoo#--##
XX------------##
XX-----------XXX
XX-----------XXX
XX-----------XXX
XXXXXXXXXXXXXXXX
