----------------
-----o----------
----------------
----------------
----SSSS--------
----------------
--------SSSS----
X-------------XX
X-------------XX
X-------------EE
X-----ESSSSXXXXX
X--oSSS---------
X---------------
X---------------
