-------##oo-----
---XHHH---------
---####---------
---#------------
MMMM---------XXX
----------------
-----------#SSS-
-------XXTT-----
-------####-----
----ooo#--------
SSSSXXX#-------<
---------------[
---------------[
-------------SS[
