SSSS------------
SSSS------------
SSSSXXXX--------
SSSSXX-oo-------
----------------
----------------
--------XXXo----
----------------
X-------------##
#-------------##
###H-------H####
#MMMSSSSSSSMMM##
#--------------#
#--------------#
