XX-----------###
XX-----------###
-XXXSSSoo--<###-
-XXXX------[###-
-XXXS------[###-
-SSSS----SSSSSS-
----------------
----------------
-------XXoooSSS-
-SSSS-----------
----------------
----------------
----SSSo--------
----------------
