ooSSSSSE----XXXX
------------XXXX
------------##TT
------EXXXX#####
------B#--------
------b#--------
XXSSSSX#----XXXX
----------------
---------TTXX---
----------------
------####------
------##--------
---#####--------
---##-----------
