ooXXS-----------
--XX------------
--XXSSS---------
-----oo---------
-----XXXXX------
--------XX------
--------oooXX---
-----------XX---
XXXX-------XXXXX
--XX-----------<
--oo###--------[
-----##--------[
-----####E-----[
---------XX----[
