SSSS------------
SSSSEooo--------
S---XXXXXXX#----
S-------ooo#####
X-----------####
X-------------<>
X-------------[]
X---Eooo------[]
X---XXXXXXXE--[]
##------TT######
##----------####
##-----------###
#TTTSSSMMM---###
#MMM-----------#
