####T-----------
--##------------
--##TTT---------
-----##---------
-----#####------
--------##------
--------#####---
-----------##---
####-------#####
--##-----------#
--#####--------#
-----##--------#
-----#####-----#
---------##----#
