X------####----#
XX-----####--T-#
XXX----####----#
##----##-------#
##TT--##-----T-#
------##-------#
-----###-------#
-------#----TT--
---##--#--------
-------#--------
#----##-------##
###--##----#####
#---H##D------##
#----##D------##
