#####---------##
#-------------##
#-------------##
####-------#####
####MMMMM###MM##
#--------------#
#--------------#
#---####-------#
#--------------#
----------------
#MMMM#######TTTT
#--------------#
#H-----------##T
#MMMM###########
