----------------
-----#######----
----------------
----------------
---####--TT##---
----------------
----------------
------TTTT------
----------------
----------TTTT--
----------------
----------------
---------TTTTTTT
----------------
