----------#-----
----------------
----------------
##----------####
##----------####
#########---####
####------######
####------####--
####T-TT######--
####------####--
##-----------###
##--TT-------###
##-----------###
##-----------###
