---------##----#
---------------#
#-----------####
#---############
#-------------##
#-------------##
####----------##
########------##
############--##
##------------##
##-----------###
##-----------###
##-----------###
################
