##-----------###
-#######H--####-
-####------####-
-####------####-
-####----######-
##----------####
##----------####
########T---####
####------TT####
####------####--
####H-H#######--
####------####--
##-----------###
##--TT-------###
