-########--####-
-####------####-
-###X------####-
-###X----######-
##----------####
##----------####
####XXXXX---####
####------######
####------####--
####T-TTT#####--
####------####--
##-----------###
##--TT-------###
##-----------###
