#######T----####
------------####
------------####
------#TTTT#####
------##--------
------##--------
########----TTTT
----------------
---------TTTT---
----------------
------####------
------##--------
---#####--------
---##-----------
