X--SS--E#####--#
X------S###----#
XX-----S###--T-#
##H----S###----#
##----##-------#
##TT--##-----T-#
------##-------#
-----T##-------#
-------#----TT--
---TT--#--------
-------#--------
------------T---
----#T---TT-----
----------------
