-------####-----
---#HHH---------
---####---------
---#------------
####---------###
----------------
-----------####-
-------####-----
-------####-----
----####--------
########-------<
---------------[
---------------[
-------------SS[
