####-----------#
---------####--#
##-------##---XX
##----#####---X-
##------------X-
##TTT---------#-
--------------##
---TT##-------##
-----##-------##
-----##TTT----##
----------------
----------------
---------TT##---
----------------
