----------------
-----oo--oo-----
----------------
----------------
--oo------------
--####o---------
-----#X---------
-----oo###------
--------##------
--------oo###---
-----------##---
oo##-------#####
--##-----------#
--#####--------#
