oo##TT-oo-----oo
SS##---XX-----XX
------T---oo----
----------------
----------------
-----TTooo------
----------------
----------------
---TTTT--oooo---
----------------
----------------
-------oo--oooo-
----------------
----------------
