----------------
-----o--o--#----
----------------
----------------
-------------#--
-------------#--
-------------#--
--DTTX--o--#-#--
--D--#--#--#----
--#--#--#--#----
TT#--#--#--o----
----------------
----------------
########--------
