---#------------
###-----------oo
####oooooo----XX
oo------------SS
SS------------SS
##----ooooooooSS
##------------##
##------------##
##TT###o------##
##----#SSSS---##
##------------##
##------------##
#####-------####
#######oooo#####
