D###----------SS
D###----------SS
####----------SS
####----ooooooSS
---#-#----------
---#------------
###-----------oo
######oooo----oo
##------------XX
##------------##
##----#ooo######
##------------##
##------------##
D######X------##
