-----oo--oo-----
----------------
----------------
------X---oo----
----------------
----------------
-----TTTTT------
----------------
----------------
---oTTT--TTTT---
----------------
----------------
-------oo--TTTT-
----------------
