----Eooo----####
ooooXXXXXooo####
SSSS---ooSSS-###
o------------T##
X-------------##
#------T---S--SS
#---HHHHHooSooSS
#--#oooooSSSSSSS
##-#------------
##-#------------
#------Q-------#
#-T------------#
#--------------#
#------E-------#
