ooooo###-------#
SSSX---#ooo----#
---------------#
-----------oH--#
---------------#
---------------#
-------------H##
---------------#
------oooooo####
------##--------
------##--------
oooooo##----oooo
----------------
----------------
