----------------
--------o-------
----------------
--------T-------
----------------
----------------
#-----TTTo-ooooo
#---------------
#---------------
#----------D#---
#----------D#--#
#-----###oo###-#
#-----##-------#
#--oo###-------#
