--------####----
--------####----
------######----
----------------
---###o---------
---##-----------
oo###-----oooooo
----------oo----
-------ooXXX----
----------------
----oooo--------
----------------
----------------
--o-------------
