--------#D------
--------#TTTT---
M##H--------TTTT
----------------
----------------
---#TE?Q#-------
----------------
--------TTTS----
----------------
M#MM#SS?----XXXX
----------------
----------------
-----ooo#-------
----------------
