----------------
---?SQ#---------
----------------
----------------
<>-----H##H---<>
[]------------[]
#D------------[]
##T?SQ----H#SS[]
##------------[]
??------------[]
S-----E?Qb-----#
---------XSST---
----------------
----------------
