##HH----------H#
MMM#------MMMMMM
----------------
----------------
MMM?SQMM#MM#SSS?
----------------
-#--------------
<>----------oooo
[]--------------
#H--------------
MMMSS?M#########
----------##----
----------##----
--#ooo----------
