----------------
---------M#QS---
----------------
----------------
ESS?SQS#H----#HH
>------------D##
]------------So?
]--E---------SSS
----------------
----------------
-T--------------
----------------
----#---<>------
--------[]------
