<>[]E?QS?SQQSSS?
[][]------------
[][]------------
XXXX----E-------
--------#-------
--------#-------
--------#-T-----
----------------
----------------
MMMMTT#TT##SSSSS
----------------
----------------
####----------SS
####----------SS
