#D--------------
##TTT-----------
----------------
---?SQ#---------
----------------
------TTTT------
----------------
---------?SQ#---
----------------
M#TT--------TTTT
----------------
---####---------
----------------
------TTT#------
