----#----E?QT---
----------------
----------------
--#TTT-----T###-
--------D-------
--------D-------
------#TTT------
----------------
----------------
--T?SS----#TT#--
----------------
----------------
###o-------#S?SQ
----------------
