###D--------<>[]
###D--------[][]
####TTT-----[][]
####------#-XXXX
#D----------XX<>
<>----------XX[]
[]----TS?SQSQQ?S
XX--------------
#D--------------
##TTTT----------
##--------------
----------------
-----###H-------
----------------
