----------------
--------?SQT----
----------------
--------------T-
----------------
----------------
-----<---#---#--
--#--[---#---B--
--#--[---#---b--
--#--X---#---B--
--#-T-----------
----------------
----------------
----MMMMT-------
