----------------
----------------
------QQQQ------
----------------
---#TTE---------
----------------
----------------
####------#S?SQS
D---------------
#---------------
D------?SQS-----
D---------------
##--------------
##--#TTE--------
