##-----------###
##------------D#
##TTS?SQS-----<>
##------------[]
----------------
---------TT##---
----------------
----------------
##------#D#MMMMM
##------------##
##------------##
####----------##
####-----------#
####-----------#
