<>[]##HH####----
[][]MMMMMM######
[][]----------##
XXXX----------##
E-------------##
>-------------##
]-----#EoooH####
X-----DXXXXMMM##
####-----[]##---
####-----XX##---
####--------####
####-#------####
D-----------####
D-----------####
