#---T--S?SSTTTT#
#--------------#
#--------------#
TTTTMMMoo------#
MMMM------------
#--------#------
----------------
----------------
----TT#TT#T#----
-----------#----
-----------#----
<>----------####
[]--------------
[]--------------
