----------------
##------E?QS?SQS
##------------<>
##------------[]
TTTT----------XX
X<>D-----------#
X[]#-----------D
X<>X<><>XXX#---#
X[]X[][]XXX----#
####----------##
#D-------------D
#D-------------D
#####---H#######
######MMMMMTTTTT
