----------------
---------#######
----------------
------#TTT------
----------------
---T###---------
--------------#-
####--------####
----------------
--------###TT---
--------#-------
------T###------
----------------
---####---------
