-------------###
#########----###
#-----###T-T####
#------------###
#-------------D#
#-------------D#
#-------------D#
#-------------D#
#-----##########
--------########
----X#######----
TTS-------------
----------------
----------------
