####--##########
####--------####
####--------####
######------####
####--------####
####--------####
####----TTTT####
####--------####
####--------####
#######TT---####
####--------####
####--------####
####-----TT#####
####--------####
