---------####---
----------------
----------------
################
----------------
----#--------#--
################
----------------
----------------
-----T#---------
----------------
---H-----H------
TTMMMMMMMM######
----------------
