####--------####
####--##########
####--------####
####--------####
######------####
####--------####
####--------D###
---####--#H#----
---####---####--
-######---####--
---#####--####--
----####--####--
----####--####--
----####-TT#####
