----------------
---------###----
----------------
#-----------TTT#
#--------------#
#--------------#
#########------#
##-------------#
D#--------######
D#-------------#
##-------------#
############---#
--########-----#
---------#TTTTTT
