----------------
----------------
####TTT---------
----------------
------TT##------
----------------
---------##TT---
----------------
####--------TTTT
-----H----------
----TTT---------
----------------
------####------
----------------
