--#--------H----
##########MMMMMM
----------------
----------------
###MMM##########
----------------
----H--------#--
###MMM##########
----------------
----------------
-----TT---------
----------------
---H-----H------
###MMMMMMM######
