-------------EXX
####EEEoo----XXX
#-----XXXE-EXXXX
E------------###
>-------------D#
]-------------D#
E-------------EX
>-------------XX
]-----E####HXXXX
--------Eooo###H
----XESSXXXX----
EES-------------
----------------
----------------
