----------------
---------Eoo----
----------------
E-----------TTT#
>--------------#
]--------------#
]EEoooEEE------#
XX-------------E
D#--------XXXXXX
D#-------------#
##-------------#
##EoEoHHH###---#
--XXXX####-----#
---------#TTTTTT
