EXXE--------EXXX
>XX>--ESSESS>XXX
]XXE--------]XXX
]XX>--------]XXX
######------####
####--------####
####--------D###
---###E--SS#----
---####---E###--
-EE####---E###--
---#####--####--
----####--####--
----####--####--
----####-TT#####
