----------------
--E--------E----
XXXEoooXXXXXEooo
----------------
----------------
EX##----EEoo####
>X##--------####
]X##--------####
EXX###ESS---EXXX
>XX#-------->XXX
]XX#--------]XXX
]XX#-----ESS]XXX
]XX#--------]XXX
XXX#--------XXXX
