--E--------H----
EEXXXXQQQQMMMMMM
----------------
----------------
H##MMMEEEEMMMMMM
----------------
----H--------E--
###MMMESSSXXXXXX
----------------
----------------
-----TT---------
----------------
---H-----H------
EEEMMMMMMM#####H
