----------------
---------QQQESSS
----------------
------EEEE------
----------------
---TESS---------
--------------E-
####--------XXXX
----------------
--------###TT---
--------#-------
------E###------
----------------
---XXXX---------
