-----E---E---E--
EEXXXXEESSSSSSSS
----------------
----------------
---#------------
---#------------
-E-#---E--------
EEESSSSSESS####H
----------------
--------------#-
------------TTTT
--------------#-
----------------
---------E------
