----EEES--------
----------TTE---
---------D------
---------D------
--------ETTT----
----------------
--E####HEE------
----------------
----------------
XXXE------------
----------------
----------------
------E?o-------
---------E#####H
