---------E------
-----E---E---E--
EEEESSSSEE######
----------------
----------------
---<------------
---[------------
-E-[---E--------
MM#M###HEE######
----------------
----------------
---------ETT----
----------------
H-----------TTTT
