----EXXX--[E<>--
---->XXX--[>[]--
----EESSE-[][]--
----------####--
----------####--
---------TTT##--
-------E--------
####HXXXMMMMMMMM
--------------#-
------------TTTT
--------------#-
----------------
---------E------
---------E------
