EXXX--EESS######
>XXX--------####
]XXX--------####
EXXXEE------####
>XXX--------Eooo
]XXX--------XXXX
]XXX----TTTTEXXX
]XXX-------->XXX
EXXX--------EXXX
>XXXEooTT--->XXX
]XXX--------####
]XXX--------####
]XXX-----E?#####
XXXX--------####
