---------ESSE---
----------------
----------------
EEEEEEEE########
----------------
----E--------E--
EEXXXXEoooEEXXXX
----------------
----------------
-----TE---------
----------------
---H-----E------
EEMMMMXXXX######
----------------
