----------------
----------------
EEEETTT---------
----------------
------TT#H------
----------------
---------EETT---
----------------
EEEE--------TTTT
-----E----------
----EXX---------
----------------
------oESS------
----------------
