####?---------<>
#-------------[]
#-------------XX
####-------TXXXX
####MMMMMSSSMM##
#--------------#
#--------------#
#---TTTT-------#
#--------------#
----------------
#MMMMMMMTTTTMMM#
#--------------#
#H-----------H##
#MMMM#MMTTTTMMM#
