##-----------XSS
-####SSSH--#XXX-
-####------#XXX-
-####------####-
-####----######-
#D----------####
[]----------####
XXXX####H---####
####------######
####------####--
####H-H#######--
####------####--
##-----------###
##--TT-------###
