----------------
----------------
#####TTTTMMMSSSS
#--------------S
E----#---------#
>--------------#
----------------
---o------------
----------------
##HHH###H--#####
-########--#####
---------T-----#
---------------#
----------------
