##-----------###
##-----------###
-XX######--<###-
-XX##------[###-
-XX##------[###-
-QQQS----######-
----------------
----------------
-------##MMM###-
-QQ?S-----------
----------------
----------------
----SSST--------
----------------
