SSSS------------
SSSS------------
SSSSMMME--------
SSSSXX-XT-------
----------------
----------------
--------###X----
----------------
S-------------##
#-------------##
###H-------H####
#MMMMMMMSS?MMM##
#--------------#
#--------------#
