##XXS-----------
--XX------------
--XXSSS---------
-----##---------
-----###XX------
--------XX------
--------SXXXX---
-----------XX---
XX##-------XXXXX
--HH-----------#
--#####--------#
-----##--------#
-----####o-----#
---------XX----#
