-------##oo-----
---SHHH---------
---####---------
---#------------
####---------XXX
----------------
-----------#SSS-
-------####-----
-------####-----
----####--------
########-------<
---------------[
---------------[
-------------SS[
