-------------###
-----------T-###
-------SSSSHHH##
-----Q-SSSS##-#-
----------------
----------------
SSS#------------
SSS#------------
SSS####X--------
MMMXXX-X#-------
----------------
----------------
--------MMMT----
----------------
