TTTT----------[]
--------------[]
--------------[]
-----------XXXXX
----T####-------
----------------
ESSS----------XX
-------------XXX
-------------XXX
-----------S-###
-------ooooSHH##
-----S-SSSSS#-#-
----------------
----------------
