----------------
-----?----------
----------------
----------------
----####--------
----------------
--------####----
X-------------#H
X-------------##
X-------------D#
#-----EXXXX#####
#--#SSS---------
#---------------
#---------------
