----------------
---------EE##---
----------------
----------------
ESSSSSS#H----Eoo
>------------XXX
]------------Eoo
]--E---------XXX
----------------
----------------
-E--------------
----------------
----E---D#------
--------D#------
