----------------
----------------
------QQQQ------
----------------
---EooE---------
----------------
----------------
####------E####H
H---------------
#---------------
#------SSSS-----
#---------------
##--------------
##--EooE--------
