EooE----------#H
XXX>------######
----------------
----------------
SSSESS##H##HH###
----------------
-E--------------
EX----------####
XX--------------
#H--------------
MMM##HEE########
----------##----
----------##----
--#H##----------
