----E----ESST---
----------------
----------------
--EQQQ-----TTTT-
--------D-------
--------D-------
------ETTT------
----------------
----------------
--HTTT----EEEE--
----------------
----------------
###H-------EESSS
----------------
