EE--------------
XXXXX-----------
----------------
---ESSE---------
----------------
------XXXE------
----------------
---------ESSE---
----------------
EETT--------XXXX
----------------
---###H---------
----------------
------TTEE------
