----------------
--------ESST----
----------------
--------------T-
----------------
----------------
-----E---#---E--
--E--S---#---#--
--#--S---#---#--
--#--S---#---#--
--#-E-----------
----------------
----------------
----XXXXE-------
