----------------
##------ESS####H
##------------##
##------------##
####----------##
EXXE-----------E
>XX>-----------E
EXXEXXEXXXX#---#
>XX>XX>XXXX----#
####----------##
#D-------------D
#D-------------D
#####---EEE#####
######XXXXX#####
