###D--------EXXX
###D-------->XXX
####TTT-----]XXX
####------E-]XXX
#D----------EXXX
EX---------->XXX
>X----E####HESSS
]X--------------
#D--------------
##TTTT----------
##--------------
----------------
-----TT#H-------
----------------
