##-----------H##
##------------##
####H####-----Eo
##------------XX
----------------
---------QQ##---
----------------
----------------
##------EEE#####
##------------##
##------------##
####----------##
####-----------#
####-----------#
