----------------
----------------
EEESSSEEEE#####H
----------------
----------------
ESSESSEEESS####H
----------------
----------------
ESESSSH#H##MMM##
>-------------##
#-------------##
###ESS#####MMM##
##--------------
##--------------
