EXXXESSSSSS#####
>XXX------------
]XXX------------
]XXX----E-------
--------#-------
--------#-------
--------#-T-----
----------------
----------------
MMMM##H###HSSSSS
----------------
----------------
####----------SS
####----------SS
