#---T--TTTTTTTT#
D--------------#
D--------------#
####TTTTT------#
####------------
E--------E------
----------------
----------------
----##H##HEE----
-----------#----
-----------#----
##----------####
##--------------
##--------------
