----------------
----------------
----------------
----------------
----------------
----------------
----------------
----------------
----------------
--------------##
--------------#-
--------------#-
#----------#-##-
################
