----------------
----------------
----------------
----------------
----------------
----------------
----------------
--#-------------
----------------
##--------------
----------------
-###------------
----------------
----#########---
