----------------
----------------
----------------
----------------
----------------
----------------
----------------
----------------
-#--------------
----------------
----------------
--------#---#---
--------#-#-#---
---#############
