----------------
----------------
----------------
----------------
----------------
----------------
----------------
----------------
----------------
-------###------
----------------
---------------#
--------------##
##--############
