----------------
----------------
----------------
----------------
----------------
----------------
####------------
----------------
--------------#-
-------------##-
-------------##-
-------------##-
-------------##-
################
