----------------
----------------
----------------
----------------
----------------
----------------
----------------
----------------
---------------#
-----###------##
--------------##
--------------##
--------------##
################
