----------------
----------------
----------------
----------------
----------------
---########-----
----------------
----------------
----------------
--#----#----#---
--#------#--#---
--#---------#---
--#---------#---
################
