----------------
----------------
----------------
----------------
----------------
-------------#--
-----#----------
---########-----
----------------
---------------#
----------------
#---------------
------------###-
------------###-
