----------------
----------------
----------------
----------------
----------------
---------##-----
---------##-----
-------####-----
-------####-----
-----######-----
-----######-----
-----######-----
-#---######-----
################
