----------------
----------------
----------------
----------------
----------------
--####----##----
----------------
----------------
----------------
##----##-----##-
----------------
----------------
----------------
----------------
