----------------
----------------
----------------
----------------
----------------
----------------
---#------------
--##------------
--##------------
--##------#-----
#-##-----##-----
#-##-----##-----
#-##-----##-----
################
