----------------
----------------
----------------
----------------
----------------
----------------
----------------
----------------
-------###-##---
------###-------
-----####-------
----#####-------
---######--#####
########-------#
