----------------
----------------
----------------
----------------
----------------
--##------------
--##------------
--##------------
--##------------
--##------------
--##------------
----------------
------------#---
################
