----------------
----------------
----------------
-------##-------
-------##-------
---#---##-------
-------##-------
-------##-------
-------##-------
--##---##-------
-------##-------
-------##-------
-------##-------
################
