----------------
----------------
----------------
--##------------
--##------------
--##------------
--##------------
--##------------
--##------------
--##------------
--##------------
--##------------
--##--------#---
################
