----------------
----------------
----------------
----------------
----------------
----------------
----------------
----------------
----------------
----------------
------#---------
------#---------
------#---------
#######--#######
