----------------
----------------
################
----------------
----------------
----------------
----------------
----------------
---------------#
-----------#--##
----#-----##--##
---##-----##--##
---##---#-##--##
-###############
