----------------
----------------
----------------
----------------
----------------
----###---------
----------------
----------------
----------------
----------------
-#---#----------
-----#-------#--
-----#-------#--
################
