----------------
----------------
----------------
----------------
----------------
----------------
----------------
-------------###
------------###-
-----------####-
----------#####-
---------######-
--------#######-
#-############--
