----------------
----------------
----------------
----------------
----------------
-----------#----
----------------
----------------
----------#-##--
-----#--------##
----###-------##
---####-------##
--####--------#-
######--------#-
