----------------
----------------
----------------
----------------
----------------
-------------##-
----------------
----------------
----------------
------------####
---------#####--
------######----
---#######------
########------##
