----------------
----------------
################
----------------
----------------
----------------
--------------#-
----------------
-------------#--
-------####-----
-----########--#
---##########--#
-#############-#
################
