----------------
----------------
----------------
----------------
----------------
-----###--------
----------------
----------------
----------------
----#####-------
----#-----------
----#-----------
----#-----------
#######----#####
