----------------
----------------
----------------
----------------
-------####-----
-------####-----
----------------
----------------
----------------
----------------
--#####---------
----------------
----------------
#-----#####-####
