----------------
----------------
----------------
----------------
#---------------
-------------###
----------------
----------------
---#######------
----------------
#---------------
----------------
------#---------
---########--###
