----------------
----------------
----------------
----------------
----------------
----------------
----------------
----------------
----------------
----------------
----#-----------
--------#-------
----------------
##-#-##-#-##-###
