----------------
----------------
----------------
----------------
----------------
-----####-------
----------------
----------------
-#--------------
##---#-----#----
##---------#----
##---------##---
##----##---##---
################
