----------------
----------------
----------------
----------------
----------------
-------###------
------####------
-----#####------
----######------
---#######------
-#########------
-#########------
##########------
################
