----------------
----------------
----------------
----------------
----------------
---------------#
----------------
------##--------
-----###--------
----####-------#
---#####--------
--######--------
-#######-----#--
#######--#######
