----------------
----------------
----------------
----------------
----------------
----------------
----------------
----------------
--------##------
----------------
----------------
----------------
----------------
######------####
