----------------
----------------
----------------
----------------
----------------
----------------
----------------
-#--------------
##--##------#---
##--------------
##--------------
##--------------
##--------------
###########---##
