----------------
----------------
----------------
----------------
----------------
--##------------
--##------------
#-##------------
#-##------------
#-##------------
#-##------------
#-##------------
#-##--------#---
#-##############
