----------------
----------------
----------------
----------------
----------------
----------------
----------------
---------#------
---------#------
-------#####----
-#--------------
-#-----------#--
-#-----------#--
################
