----------------
----------------
----------------
----------------
--------##--##--
##--------------
----------------
----------------
-##-------------
---------##-----
----------------
-------------###
----------------
----------------
