----------------
----------------
----------------
----------------
----------------
----------------
----------------
----------------
----------------
---#--#---------
--##---------#--
------------##--
-----#----------
################
