----------------
----------------
----------------
----------------
----------------
##--------------
----------------
----------------
--####----------
----------------
----------------
----------------
-------------##-
------##########
