----------------
----------------
----------------
----------------
----------------
----------------
----------------
----------------
-------------#--
------------##--
------------##--
------------##--
##-------#--##--
################
