----------------
----------------
----------------
----------------
----------------
---------#-#----
----------------
----------------
----------------
---------#-#----
----------------
----------------
----------------
################
