----------------
----------------
----------------
----------------
----------------
----------------
----------------
----------------
-########-------
----------------
----------------
----------------
----------------
##############-#
