----------------
----------------
----------------
----------------
----------------
----------------
----------------
----------------
#---------------
#---------------
----------------
----------------
------------##-#
######---#######
