----------------
----------------
----------------
----------------
----------------
---##-----------
-----------##---
----------------
----------------
###--####-------
----------------
----------------
----------------
------------####
