----------------
----------------
#---------------
----------------
----------------
----------------
--##------------
-------#--------
------##-------#
-----###------##
----####-----###
---#####----####
--######---#####
#-##############
