----------------
----------------
----------------
----------------
----------------
----------------
----------------
----------------
----------------
-------##--#----
------###--##---
-----####--###--
----#####--####-
#########--#####
