----------------
----------------
################
----------------
----------------
----######------
----------------
----######------
----######------
----------------
----------------
----------------
----------------
---#############
