----------------
----------------
----------------
----------------
----------------
---------------#
----------------
----------------
----------------
---------------#
----------#-----
---#-----##-----
---#-----##-----
################
