----------------
----------------
----------------
----------------
----------------
----------------
----------------
----------------
----------------
----------------
----#-----------
----------------
-----------###--
################
