----------------
----------------
----------------
----------------
----------------
--------------##
----------------
----------------
--------#-------
-------##----###
-------##-------
-------##-------
##-----##-------
################
