----------------
----------------
---#############
----------------
----------------
###------------#
--------------##
#-------------##
-#------------##
--#------#--####
--------##----##
--------##----##
--------##-#--##
################
