----------------
----------------
----------------
----------------
----------------
----------------
-------------###
----------------
----------------
-----##-#-------
--############--
----------------
----------------
##--------------
