----------------
----------------
----------------
----------------
----------------
###-----#####---
----------------
----------------
----------------
------------##--
------#----##---
-----##----##--#
-----##----##--#
################
