##-#-----------#
#--#####-------#
#--#-----------#
#-T#-----####--#
#--#-----------#
#--#----------##
##-#----------##
#--#----------##
#--#---#########
--##---[#-------
---#---[#-------
---#-SS[#-------
####---[#-----XX
####---[#---XXXX
