--------####----
--------####----
------######----
----------------
---####---------
---##-----------
#####-----######
----------##----
-------TT###----
----------------
----TT##--------
----------------
----------------
--#-------------
