-----TT--##-----
----------------
----------------
------T---##----
----------------
----------------
-----TTTTT------
----------------
----------------
---#TTT--TTTT---
----------------
----------------
-------TT--TTTT-
----------------
