<>##----------<>
[]##----------[]
[]##----------[]
XX##----S?XXXXXX
---#-#----------
---#------------
<>#-----------D#
[]####S?SQ----<>
XX------------[]
E<------------##
>[----T?SQ######
][------------##
][------------##
XX#####E------##
