-----S?--##-----
----------------
----------------
------E---QS----
----------------
----------------
-----<>TTT------
----------------
----------------
---#XXX--##TT---
----------------
----------------
-------#H--TTTT-
----------------
