--------###>----
--------###]----
------H####X----
----------------
---####---------
---##-----------
#T###-----#TS?SQ
----------[]----
-------H#SXX----
----------------
----S?QS--------
----------------
----------------
--#-------------
