B--B------#MMMMM
b--b----------##
XS-B----------##
#--TT---------##
D--E----------##
#-T>----------##
#--]-----####-##
#--#----------<>
#T-D----------[]
#--TTTT#------XX
#--#----------##
#-T#-----------#
#--#----E?Q#---#
#--#-----------#
