##H#TTTT-------<
MMM#---###H----[
---------------X
-----------#H--#
---------------#
---------------#
-------------H##
---------------D
------E?Q?SQ####
------<>--------
------[]--------
?SQ?SQXX----S?SQ
----------------
----------------
