#D##TT-<>-----<>
#T##---[]-----[]
------T---QS----
----------------
----------------
-----H#?SQ------
----------------
----------------
---####--M#QS---
----------------
----------------
-------T#--?SQS-
----------------
----------------
