----------------
-----TQ--?#-----
----------------
----------------
--#T------------
--MMMMD---------
-----##---------
-----H#S[]------
--------[]------
--------#T###---
-----------##---
M#<>-------#####
--[]-----------#
--XXXXX--------#
