ES-<-----------<
>--[S?SQ-------[
]--[-----------X
]-SX-----#T##--#
>--E-----------#
]-->----------##
]E-]----------##
E--<----------H#
>--[---#?SQMMMMM
--##---[E-------
---#---[>-------
---#-SS[]-------
####---[]-----XX
####---[X---XXXX
