----------------
--------#-------
----------------
--------T-------
----------------
----------------
E-----###X-SS?SQ
>---------------
]---------------
X----------D#---
E----------D#--#
>-----###T####-#
]-----##-------#
X--#T###-------#
