----###H----T##D
#HHH#MMMM##H####
D###---H#MMM-###
D------------T##
#-------------##
#------T---T--D#
#---HHHHHHHH####
#--#S?SQS###TTTT
##-#------------
##-#------------
#------Q-------#
#-T------------#
#--------------D
#------E-------D
