---#------------
###-----------<>
####?SQTT#----[]
<>------------<>
[]------------[]
##----#S?SQXXXXX
##------------<>
##------------[]
##TT####------XX
##----#SSQS---##
##------------##
##------------##
#TTT#-------####
#MMM###XXXX#####
