----------------
---SSSX---------
----------------
----------------
XX-----oooo---XX
XX------------XX
XX------------XX
XXXSSS----ooSS[]
XX------------[]
XX------------[]
o-----SSSE-----#
---------SSS#---
----------------
----------------
