----------------
--------SSST----
----------------
--------------T-
----------------
----------------
-----X---#---X--
--X--X---#---X--
--#--X---#---X--
--#--X---#---X--
--#-E-----------
----------------
----------------
----XXXXX-------
