----------------
---------oooo---
----------------
----------------
ESSSSSSoo----XXX
>------------XXX
]------------ooo
]--E---------XXX
----------------
----------------
-o--------------
----------------
----o---XX------
--------XX------
