----------------
##------SSSXXXXX
##------------<>
##------------[]
TTTT----------[]
XXXX-----------X
XXXX-----------X
XXXXXXXXXXX#---#
XXXXXXXXXXX----#
####----------##
#D-------------S
#D-------------S
#####---XXXooooS
######XXXXXSSSSS
