##-----------TTT
##------------##
####SSSSS-----XX
##------------XX
----------------
---------ooTT---
----------------
----------------
##------XXXMMMMM
##------------##
##------------##
####----------##
####-----------#
####-----------#
