oooB----------##
XXXb------TTTTTT
----------------
----------------
SSSSSSSSSSSSSSS?
----------------
-?--------------
XX----------oooo
XX--------------
#H--------------
MMMSSSooSSS#####
----------S#----
----------S#----
--#SSS----------
