----------------
----------------
------QQQQ------
----------------
---XXXE---------
----------------
----------------
####------oSSSSS
#---------------
#---------------
#------SSSS-----
#---------------
##--------------
##--XXXE--------
