XX--------------
XXXXX-----------
----------------
---SSSE---------
----------------
------XXXX------
----------------
---------SSSb---
----------------
ooSS--------XXXX
----------------
---SSST---------
----------------
------##XX------
