--------XX------
--------ooTTT---
oooo--------TTTT
----------------
----------------
---ooSSSS-------
----------------
--------SSSo----
----------------
ooSSSSSS----XXXX
----------------
----------------
-----SSSo-------
----------------
