XXXXSSSSSSSSSSSS
XXXX------------
XXXX------------
XXXX----E-------
--------#-------
--------#-------
--------#-T-----
----------------
----------------
MMMMSSSSSSSSSSSS
----------------
----------------
####----------SS
####----------SS
