XXX#--------XXXX
XXX#--------XXXX
XXX####-----XXXX
XXX#------X-XXXX
XX----------XXXX
XX----------XXXX
XX----oXXXXXSSSS
XX--------------
##--------------
###TTT----------
##--------------
----------------
-----TToo-------
----------------
