----o----SSSo---
----------------
----------------
--oXXX-----TXXX-
--------D-------
--------D-------
------XTTT------
----------------
----------------
--#ooo----XXXX--
----------------
----------------
MMMX-------oSSSS
----------------
