##-----------###
##------------D#
####XXXXX-----XX
##------------XX
----------------
---------oo##---
----------------
----------------
##------XXX#####
##------------##
##------------##
####----------##
####-----------#
####-----------#
