----------------
----------------
------XXXX------
----------------
---XXXX---------
----------------
----------------
####------XXXXXX
#---------------
#---------------
#------XXXX-----
#---------------
##--------------
##--XXXX--------
