XXXXXXX####XXXXX
XXXX------------
XXXX------------
XXXX----#-------
--------#-------
--------#-------
--------#-T-----
----------------
----------------
MMMMXXXXXXXSSSSS
----------------
----------------
####----------SS
####----------SS
