----------------
---XXXX---------
----------------
----------------
XX-----XXXX---XX
XX------------XX
XX------------XX
XXXXXX----XX####
XX------------##
XX------------##
o-----XXXE-----#
---------XXXT---
----------------
----------------
