--------XX------
--------XXTTT---
XXXX--------TTTT
----------------
----------------
---XXXXXX-------
----------------
--------XXXS----
----------------
XXXXX###----XXXX
----------------
----------------
-----###X-------
----------------
