----#----XXXo---
----------------
----------------
--XXXX-----TXXX-
--------D-------
--------D-------
------XTTT------
----------------
----------------
--TXXX----XXXX--
----------------
----------------
TTTX-------XXXXX
----------------
