----------------
----------------
XXXXXXXXXXXXXXXX
----------------
----------------
XXXXXXXXXXXXXXXX
----------------
----------------
XXXXXXoo###MMM##
X-------------##
#-------------##
###XXXXX###MMM##
##--------------
##--------------
