#---o--ooooTTTT#
D--------------#
D--------------#
####XXXXX------#
####------------
X--------X------
----------------
----------------
----XXXXXXXX----
-----------#----
-----------#----
XX----------####
XX--------------
XX--------------
