XX--------------
XXXXX-----------
----------------
---XXXX---------
----------------
------XXXX------
----------------
---------XXXX---
----------------
XXXX--------XXXX
----------------
---XXX#---------
----------------
------TTXX------
