----------------
---------XXXX---
----------------
----------------
XXTTTTTXX----XXX
X------------XXX
X------------Eoo
X--H---------XXX
----------------
----------------
-X--------------
----------------
----#---XX------
--------XX------
