XXXD--------XXXX
XXXD--------XXXX
XXX#TTT-----XXXX
XXX#------X-XXXX
XX----------XXXX
XX----------XXXX
XX----XXXXXXXXXX
XX--------------
#D--------------
##TTTT----------
##--------------
----------------
-----TTXX-------
----------------
