----------------
--------XXXT----
----------------
--------------T-
----------------
----------------
-----X---#---X--
--X--X---#---X--
--#--X---#---X--
--#--X---#---X--
--#-X-----------
----------------
----------------
----XXXXX-------
