XXXXEooEooo#----
XXXXXXXXXXX#####
XXXX----------##
XXXX----------##
X-------------SS
X-------------SS
X-----XXXXXoooSS
X-----XXXXXXXXXX
####-----oo##---
####-----XX##---
####--------####
####-#------####
D-----------####
D-----------####
