#------XD##----#
##-----X###--T-#
##H----X###----#
##----EX-------#
##TT--EX-----T-#
------XX-------#
-----XXX-------#
-------[----EE--
---EE--[--------
-------#--------
#----##-------##
#TT--##----#####
#---H##D------##
#----##D------##
