EESSSSSE----Eooo
------------XXXX
------------#HHH
------EXXXX#####
------##--------
------##--------
EEESS###----TTTT
----------------
---------TTTT---
----------------
------####------
------##--------
---#####--------
---##-----------
