-EooSSSSE--XE<>-
-XXXE------X>[]-
-###E------####-
-###E----EE####-
##----------####
##----------####
####XXXXX---####
EXXX------X#####
>XXX------X###--
]XXXH-H##EX###--
####------####--
##-----------###
##--#H-------###
##-----------D##
