MMSS-----------X
---------EXEE--X
H#-------XX---XX
MM----EXXXX---X-
Eo------------X-
XXTTT---------#-
--------------##
---TTEE-------##
-----XX-------##
-----##TTT----##
----------------
----------------
---------TT##---
----------------
