#####---------Eo
H-------------XX
#-------------EE
####-------EXXXX
####MMMMMESSMM##
#--------------#
#--------------#
#---####-------#
#--------------#
----------------
#MMMM##H####MMM#
#--------------#
#H-----------H##
#MMMMH######MMM#
