##-----------###
-####ESSH--####-
-####------####-
-#HHH------E###-
-####----SSS###-
HH----------####
EE----------####
XXXXESSSH---####
####------######
####------####--
####H-H#######--
####------####--
##-----------###
##--TT-------###
