----------------
----------------
####HESSSESS####
#--------------#
E----E---------E
>--------------E
----------------
---E------------
----------------
##HHHEooo--#####
-####XXXX--#####
---------T-----#
---------------#
----------------
