EEEXT-----------
-->X------------
--]XTTT---------
-----EE---------
-----XXXH#------
--------##------
--------EEE##---
-----------##---
EEEE-------##HHH
--Eo-----------#
--XX###--------#
-----##--------#
-----####E-----#
---------XX----#
