----------------
-----EEoooEE----
----------------
----------------
---EEEE--TT##---
----------------
----------------
------ESTT------
----------------
----------TTTT--
----------------
----------------
---------TTTTTTT
----------------
