EX-----------###
XX-----------###
-######EE--####-
-####------####-
-####------####-
-##TT----##H###-
----------------
----------------
-------EEH#####-
-####-----------
----------------
----------------
----ESSE--------
----------------
