-------####-----
---EHHH---------
---####---------
---#------------
####---------Eoo
----------------
-----------T##H-
-------EE##-----
-------####-----
----Eoo#--------
ESSSXXX#-------<
---------------[
---------------[
-------------SS[
