---------------#
E-----------####
>---EE####H#####
o-------------##
E-------------##
XXEE----------##
EXEoooEE------##
>XXXXXXXESS#--##
]X------------##
EX-----------###
>X-----------###
]X-----------###
]XEoooEEEooo####
]XXXXXXXXXXX####
