----------------
-----E----------
----------------
----------------
----###H--------
----------------
--------ESSS----
E-------------Eo
>-------------XX
]-------------EE
#-----EESSSXXXXX
#--TSSS---------
#---------------
#---------------
