E---ESSE-------#
>--------------#
----------------
#MMMESSXXXXMMMM#
#--------------#
#H-----------H##
ESSSESSESSSMMMM#
----------------
----------------
#----##-------##
#TT--##----#####
#---H##-------##
#----##-------##
#--TT--######--#
