-------------###
-----------T-###
-------EoooHHH##
-----E-XXXX##-#-
----------------
----------------
####------------
####------------
######HE--------
##H###-#T-------
----------------
----------------
--------TTTE----
----------------
