---------EE----#
---------------#
E-----------#HHH
>---####HEEH####
E-------------##
>-------------##
####----------##
####H##H------##
#####MMMMEET--##
##------------##
##-----------###
##-----------###
##-----------###
###EooEooEEH####
