----------E-----
----------------
----------------
##----------####
##----------####
##HHHEooE---####
EXXX------EX####
>XXX------XX##--
####E-EEXXXX##--
####------####--
##-----------###
##--#H-------###
##-----------D##
##-----------D##
