#HHH------------
####Eooo--------
H---XXXXXEo#----
#-------EXX#####
E-----------####
>-------------<>
]-------------[]
]---Eooo------[]
]---XXXXXEEE--[]
##------H#######
#D----------####
#D-----------###
####ESS###---###
####-----------#
