X--SS--E#HHHE--X
X------S###----X
XX-----SHHH--Q-E
##H----S###----E
##----##-------#
##TT--##-----T-#
------##-------#
-----HT#-------#
-------#----TT--
---##--#--------
-------#--------
------------T---
----ET---#H-----
----------------
