####------------
####------------
####EooE--------
######-#T-------
----------------
----------------
--------TTTE----
----------------
E-------------##
#-------------##
###H-------H####
#MMMESSSESSMMM##
#--------------#
#--------------#
