####----------##
####----------##
####----------##
####----########
---#-#----------
---#------------
###-----------TT
##########----##
##------------##
##------------##
##----#TTT######
##------------##
##------------##
#######T------##
