#--#------######
#--#----------##
##-#----------##
#--TT---------##
#--#----------##
#-T#----------##
#--#-----TT##-##
#--#----------##
#T-#----------##
#--#####------##
#--#----------##
#-##-----------#
#--#----####---#
#--#-----------#
