---#------------
###-----------##
##########----##
##------------##
##------------##
##----##########
##------------##
##------------##
########------##
##----#####---##
##------------##
##------------##
#####-------####
################
