########-------#
####---#TTT----#
---------------#
-----------##--#
---------------#
---------------#
-------------###
---------------#
------##########
------##--------
------##--------
########----####
----------------
----------------
