E<>D--------<>[]
>[]#--E?Q?SQ[][]
][]D--------[][]
][]#--------XXXX
######------####
####--------####
#TT#--------D###
---#MM#--#HT----
---####---####--
-#TT###---D###--
---#####--#>[]--
----####--#][]--
----####--#][]--
----####-TTXXXXX
