---------E?Q#---
----------------
----------------
M#M#M#T#SSQSSS?S
----------------
----b--------b--
#TSSXSS?SQ#TSXSS
----------------
----------------
-----T#---------
----------------
---H-----H------
T#MMMMMMMMSQSSS?
----------------
