----------------
---------E?Q----
----------------
E-----------TTT#
>--------------#
]--------------#
]ES?SQ#T#------#
XX-------------D
<>--------######
[]-------------#
[]-------------#
XX#H#HHHH###---#
--MMMM####-----#
---------#TTTTTT
