--D--------H----
#T#TTTTTTTMMMMMM
----------------
----------------
SS?MMMD#D#######
----------------
----#--------H--
oooTTTS?SQMMMMMM
----------------
----------------
-----TT---------
----------------
---H-----H------
#TTMMMMMMMSQSSS?
