-------------<>X
MMMMM###H----[]X
#-----MMM>-XX[]X
E------------###
>-------------D#
]-------------D#
E-------------<>
>-------------[]
]-----#S?SQSXXXX
--------H###MMM#
----XE?QMMM#----
M#S-------------
----------------
----------------
