----------------
---------###QQ?S
----------------
------#T#T------
----------------
---TE?Q---------
--------------T-
####--------HHHH
----------------
--------B##TT---
--------b-------
------TSXT------
----------------
---D###---------
