----------------
------EM##------
----------------
---T#?S---------
--------------#-
MM##--------####
----------------
---------ETTT---
----------------
------D#?S------
----------------
---?SQS---------
----------------
----------------
