----XX<>--<E<>--
----XX[]--[>[]--
----#?SQE-[][]--
----------####--
----------####--
---------TTT##--
-------E--------
S?SQSX<>MMMMMMMM
--------------#-
------------TTTT
--------------#-
----------------
---------B------
---------b------
