---------B------
-----H---b---#--
M#M#MMMMM#MMMM#M
----------------
----------------
---<------------
---[------------
-E-[---#--------
MM#MTT##M#SQSSS?
----------------
----------------
---------#SS----
----------------
H-----------XXXX
