XX<>--#E?Q######
XX[]--------####
XX[]--------####
<>XXT#------####
[]XX--------<>XX
[]XX--------[]XX
[]XX----####XX<>
XXXX--------XX[]
EXXX--------XX<>
>XXX?SQTT---XX[]
]XXX--------D###
]XXX--------D###
]XXX-----H#TT###
XXXX--------####
