--------------
--------------
--------------
--------------
--------------
--#-----------
--------------
--------------
--------------
##--#---------
--------------
-----##-------
-----##-------
-----#########
