--------------
--------------
--------------
--------------
--------------
--------------
--------------
--------------
--------------
--###---------
--------------
--------------
--------------
--#####-###---
