--------------
--------------
--------------
--------------
--------------
--------------
--------------
--------------
--------------
#-------------
--------------
--------------
--------------
#########--###
