--------------
--------------
--------------
--------------
--------------
-#------------
--------------
--------------
--------------
##-##-----#---
--------------
--------------
--------------
############--
