--------------
--------------
--------------
--------------
--------------
--------------
--------------
--------------
--------------
--------#-----
--------------
--------------
--------------
-#############
