--------------
--------------
--------------
--------------
--------------
--------------
--------------
--------------
--------------
---###--------
--------------
--------------
--------------
##############
