--------------
--------------
--------------
--------------
--------------
--------##----
--------------
--------------
--------------
--------------
-------------#
------#-------
------#------#
--#---########
