--------------
--------------
--------------
--------------
--------------
----------####
--------------
--------------
--------------
--------------
--------------
--------------
--------------
##############
