--------------
--------------
--------------
--------------
--------------
##------------
--------------
--------------
------#-------
-----##-------
--------------
--------------
--------------
#####----#--##
