--------------
--------------
--------------
--------------
--------------
#-------------
--------------
--------------
--------------
----------##--
--------------
--------------
--------------
#######-######
