--------------
--------------
--------------
--------------
--------------
----###-------
--------------
--------------
--------------
#-------------
--------------
--------------
--------------
##############
