--------------
--------------
--------------
--------------
--------------
--------------
--------------
--------------
--------------
------#-------
#-------------
#-------------
#-------------
##########-###
