--------------
--------------
--------------
--------------
--------------
----#---------
--------------
--------------
--------------
------#-#-----
--------------
--------------
--------------
#########-----
