--------------
--------------
--------------
--------------
--------------
-#------------
--------------
--------------
--------------
--------------
--------------
--------------
--------------
##############
