--------------
--------------
--------------
--------------
--------------
--------------
--------------
-------------#
-------------#
-------------#
----------#---
----------#---
----------#---
#########--###
