--------------
--------------
--------------
--------------
--------------
------------##
--------------
------------#-
--------------
-------####---
-------#------
------###-----
-------#------
##############
