--------------
--------------
--------------
--------------
--------------
--------------
--------------
--------------
--------------
--------------
------#-------
------#-------
------#-------
##############
