--------------
--------------
--------------
--------------
--------------
--------------
--------------
--------------
--------------
-----------#--
--------------
-------#------
---#---#------
##############
