--------------
--------------
--------------
--------------
--------------
------------##
--------------
--------------
--------------
------#-------
--------------
--------------
--------------
##############
