--------------
--------------
--------------
--------------
--------------
--##----------
--------------
--------------
--------------
-#----------##
--------------
--------------
--------------
##############
