--------------
--------------
--------------
--------------
--------------
--------------
--------------
--------------
--------------
##------####--
--------------
--------------
--------------
######--------
