--------------
--------------
--------------
--------------
--------------
--------------
--------------
--------------
--------------
--#-----------
--------------
--------------
--------------
#########-----
