--------------
--------------
--------------
--------------
--------------
-####---------
--------------
--------------
--------------
--#-----------
--------------
--------------
--------#-----
##############
