--------------
--------------
--------------
--------------
--------------
---###--------
--------------
--------------
#-------------
#-------------
#-------------
#-------------
#-------------
##########--##
