--------------
--------------
--------------
--------------
--------------
--------------
--------------
--------------
--------------
---####----#--
--------------
--------------
--------------
##############
