--------------
--------------
--------------
--------------
--------------
--------------
--------------
--------------
--------------
-----###------
--------------
--------------
--------------
##############
