--------------
--------------
--------------
--------------
--------------
--------------
--------------
--------------
--------------
------------#-
------#-------
--------------
--------------
--############
