--------------
--------------
--------------
--------------
--------------
-----#--------
--------------
--------------
--------------
-----#--------
--------------
--------------
--------------
##--##########
