--------------
--------------
--------------
--------------
--------------
--------------
--------------
--------------
--------------
----#-#-----##
--------------
--------------
--------------
##############
