--------------
--------------
--------------
--------------
--------------
--------------
--------------
--------------
-----------#--
----#-#-------
--------------
--------------
-------#------
##############
