--------------
--------------
--------------
--------------
--------------
--------------
--------------
--------------
--------------
--#---#-------
--------------
--------------
-----------#--
##############
