--------------
--------------
--------------
--------------
--------------
--------------
--------------
--------------
--------------
--------------
------#-------
------##------
------##------
#-##-#########
