--------------
--------------
--------------
--------------
--------------
--------------
--------------
--------------
--------------
##--------#---
---------##--#
--------###--#
---------##--#
##############
