--------------
--------------
--------------
--------------
--------------
--------------
--------------
--------------
--------------
--------------
#--#----------
#-------------
#--#----------
##-###########
