--------------
--------------
--------------
--------------
--------------
--------------
--------------
--------------
--------------
--------------
-------#------
-------#------
-------#------
----#-#######-
