--------------
--------------
--------------
--------------
--------------
--------------
--------------
--------------
--------------
------#-#-----
--------------
--------------
--------------
--############
