--------------
--------------
--------------
--------------
--------------
##------------
--------------
--------------
--------------
--------##----
--------------
--------------
--------------
##############
