--------------
--------------
--------------
--------------
--------------
--------------
--------------
--------------
--------------
----#-----#---
--------------
--------------
--------------
##############
