--------------
--------------
--------------
--------------
--------------
--------------
--------------
--------------
--------------
------###-----
--------------
----#----#----
----#----#----
--#-#-#--#####
