--------------
--------------
--------------
--------------
--------------
--------------
--------------
--------------
--------------
--------------
------------#-
-----------##-
-----------##-
#-----########
