--------------
--------------
--------------
--------------
--------------
--###---------
--------------
--------------
----#---------
------------##
--------------
--------------
------#-------
#############-
