--------------
--------------
--------------
--------------
--------------
--------------
--------------
--------------
--------------
---------#----
--------------
--------------
--------------
##############
