--------------
--------------
--------------
--------------
--------------
----------#---
--------------
--------------
--------------
--#-----------
--------------
---#----------
---##---------
###########-##
