--------------
--------------
--------------
--------------
--------------
------------#-
--------------
--------------
--------------
----#---------
----#---------
----#---------
----#---------
##############
