--------------
--------------
--------------
--------------
--------------
--------------
--------------
--------------
--------------
--------#-#---
--------------
--------------
--------------
####----######
