--------------
--------------
--------------
--------------
--------------
--------------
--------------
--------------
--------------
---------#--#-
--------------
--------------
--------------
#####---###-##
