--------------
--------------
--------------
--------------
--------------
--------###---
--------------
--------------
--------------
---#-----##---
--------------
--------------
--------------
##############
