----####----T##D
#########ooo####
TTTT---S?XXX-###
X------------TTT
X-------------##
#------H---#--D#
#---MMMMM##T####
#--#SSSSS###TTTT
##-#------------
##-#------------
#------Q-------<
#-T------------[
#--------------[
#------E-------[
