####----------[]
####----------[]
####----------[]
TT##----XXXXXXXX
---#-#----------
---#------------
XX#-----------XX
XX####SSSS----##
XX------------##
##------------##
##----TMMM######
##------------##
##------------##
########------##
