-----TT--#Q-----
----------------
----------------
------T---XX----
----------------
----------------
-----TTTTT------
----------------
----------------
---STTT--##TT---
----------------
----------------
-------SS--TTTT-
----------------
