----------------
-----o--S--#----
----------------
----------------
-------------#--
-------------#--
-------------#--
--DTTE--S--#-#--
--D--#--#--#----
--#--#--#--#----
TT#--#--#--#----
----------------
----------------
########--------
