-----##--------#
-----#####-----#
---------##----#
---------SS----#
---------------#
------------####
------------##--
---------#####--
---------##-----
------###-------
------##--------
---#####--------
---##-----------
---##-----------
