#--X------ETTTTT
#--X----------##
TT-X----------##
X--#H---------##
X--S----------##
#-TS----------##
#--S-----H###-##
#--#----------<>
#T-#----------[]
#--#####------[]
#--#----------##
#-T#-----------#
#--D----QQQ#---#
#--D-----------#
