TT##------------
----------------
----------------
------###-------
----------------
----------------
----####--------
----------TTT---
----------------
----------------
--------TT##----
----------------
--TT######------
----------------
