----------------
####------------
----------------
----------------
------TTT-------
----------------
---------###----
----------------
#-----------TTTT
#--------------#
#--------------#
#####TTTT------#
##-------------#
##--------TTTTTT
