----####--####--
----####--####--
----#####-####--
----------####--
----------####--
---------TTT##--
-------#--------
########MMMMMMMM
--------------#-
------------TTTT
--------------#-
----------------
---------#------
---------#------
