----------------
------T###------
----------------
---TT##---------
--------------#-
####--------####
----------------
---------TTTT---
----------------
------####------
----------------
---TTTT---------
----------------
----------------
