---------#------
-----H---#---#--
TTTTMMMM########
----------------
----------------
---#------------
---#------------
-T-#---#--------
################
----------------
----------------
---------#TT----
----------------
T-----------TTTT
