-----#---H---H--
########MMMMMMMM
----------------
----------------
---#------------
---#------------
-#-#---#--------
################
----------------
--------------#-
------------TTTT
--------------#-
----------------
---------#------
