----####--------
----------TT#---
---------D------
---------D------
--------#TTT----
----------------
--T#######------
----------------
----------------
TTT#------------
----------------
----------------
------TTE-------
---------X######
