----------TTTTTT
-------####-----
-------TTTT-----
---------------#
-E##H--------###
XX----------####
----------------
------EETT------
SSSSSSXX--------
----------------
------------####
----------------
--------MMMMTTTT
----------------
