-----------TTTT-
----------------
----------------
-EE#HH###-------
----------------
----------------
SS##--------####
SS##--------####
SS####E-----####
###S--------####
##------------##
##-----#TT#---D#
##------------D#
#TTS--------####
