#TMMMXXX-----XXX
#----XXXTT--XXXX
#--H#XXXH--####-
#-MMMXXXTT----##
#-------------##
#-------------D#
#-------------D#
]-<---------####
]-[-----MMMM----
XXXXXXXX--##TTTT
----------------
---------------X
-S?SSSSSS----XXX
------------XXXX
