------TTT-------
---D###--T#H----
---DXXX---####--
-TTTXXX---####--
---#XXXX--####--
----XXXX--XXXX--
----XXXX--XXXX--
----XXXX-#XXXXXX
----SS##--####--
----SS##--####--
----SSTTT-####--
----------####--
----------####--
---------TTT##--
