----------------
---------###----
----------------
#-----------####
#--------------#
#--------------#
#########------#
##-------------#
##--------######
##-------------#
##-------------#
############---#
--########-----#
---------#TTTTTT
