--#--------D----
##########TTTTTT
----------------
----------------
###MMM####TTTTTT
----------------
----H--------#--
###MMM##########
----------------
----------------
-----TT---------
----------------
---H-----H------
###MMMMMMM######
