----####--####--
----####--####--
----#####-####--
----------D###--
----------D###--
---------TTT##--
-------#--------
########TTTMMMMM
--------------#-
------------TTTT
--------------#-
----------------
---------#------
---------#------
