----------------
----------------
####TTT---------
----------------
------TT##------
----------------
---------##TT---
----------------
####--------TTTT
-----E----------
----TSS---------
----------------
------E###------
----------------
