----------------
------####------
----------------
---TT##---------
--------------#-
####--------TTTT
----------------
---------#TTT---
----------------
------####------
----------------
---TTTT---------
----------------
----------------
