-----------------------------------------------------------------------------------------------------------------------------------------------------------------------------------------------------
-----------------------------------------------------------------------------------------------------------------------------------------------------------------------------------------------------
-----------------------------------------------------------------------------------------------------------------------------------------------------------------------------------------------------
---------------------------------------------------------------------------------------------------------------------------------------------------------------------------------------##------------
---------------------------------------------------------------------------------------------------------------------------------------------------------------------------------------##------------
---------------------####---------------------#####-----------####--------#####------####-----------------------------####-----------------------------------#####---#-------------#---##------------
---------------------------------------------------------------------------------------------------------------------------------------------------------------------------------------##------------
----------------------------------------------------------------------------------------------------------------------------#----------------------------------------------------------##------------
-----------------#----------------------#---------------------------#----------------------------#------------------#------##----------------------------------------------------------##------------
--------###-----##---#-----#-----------##----######----------#-----##---####--###---------------##-----------------##---#--##-----------------------------#---#-----------#-------##---##------------
---------------###---------#-----------##--------------------------##---------------------------##-----------#-----##--##--##----------------------#---------------#-----##------------##------------
--------------####---------##----------##--------------------------##---------------------------##----------##-----##--##--##------------------#---#---------------------##------------##------------
-------------#####----##---##---##-----##-----------#-#--#--##-#---##-------#-##-------------#--##--------#-##--#--##--##--##----------------------#-----##--------------###-----------##--------#---
#####################################################################################----##########---##############################---##########--##################################################
