----------------------------------------------------------------------------------------------------------------------------------------------------------------------------------------
----------------------------------------------------------------------------------------------------------------------------------------------------------------------------------------
----------------------------------------------------------------------------------------------------------------------------------------------------------------------------------------
----------------------------------------------------------------------------------------------------------------------------------------------------------------------------------------
----------------------------------------------------------------------------------------------------------------------------------------------------------------------------------------
-----------------------------##---------------------------------------------------------------------------#--------------------------------------------------------------###------------
----------------------------------------------------------------------------------####-----------------------------------------------------------------------------------###------------
-------------------------------------#-------------------------------##----------###---------------------------------------------------------###--#----------------------###------------
--------------------------------------------------------------------------------####--------------###------------------###-##---------------###-----------------------##-###------------
---------##-----------------####--###------------------###-------###------------####------------#---------#-----------###------------------####-##-------------------###-###------------
-------------------------#####----------------------------------####----------######-###-------##--------------------####-----------------#####---------------------####-###------------
----------------------######-----------------------------------#####---------#######-----------##-------------------#####----------------######--###---------------#####-###------------
-------------------#######------------------------------------######------------####-----------##------------------######--#####--------#######-------------------######-###-------##---
#############--#########------##--################--###############---################---###############################-------##-############------#########---#######--###############
