------------------------------------------------------------------------------------------------------------------------------------------------------
------------------------------------------------------------------------------------------------------------------------------------------------------
--------------------------------##--------------------------------------------------------------------------------------------------------------------
------------------------------------#--#--------------------------------------------------------------------------------------------------------------
---------------------####----------#######-------------####----------#------------------##--##--------------------------------------------------------
---------------------#####-----------------------------####----------#--#-------##---------------------------#-----##--------------------##-----------
---------------------------------------------##------------------------######------------------------#---------------------##------------##-----------
---------------------------------------------------------------------------------------------------########----------------------------####-----------
------------------------------#####----------------------------------------------##----------------------------------------------------####-----------
-------------------########--------------------------------------###---------------------##--------------------####--####------------######-----------
--------------------------------------------------###-#------------------------------------------------------------------------------######-----------
----------------------------#----------------------------------------------------------------####------------------------------------######-----------
-------------####----------###------------------------------------------------------------------------------###------------------#---######--------#--
###########----------------------------------####-----#####-#####-------------------------------------------###-------------##########################
