---------------------------------------------------------------------------------------------------------------------------------------------------------------------
---------------------------------------------------------------------------------------------------------------------------------------------------------------------
-----------------------##-------------------------------------------------------###-------------------------------------------------------------------------------#--
--------------------------------------------------#-----------------------------####-----------------------------------------------------------------##--------------
--------------------------------------#######----------###-----------------------------------------------------------------------------------------------------------
-----------------------###---------##-----------------------------####----##---------------------------------------###-----##--####--------------------####----------
------------------------------------------------##------------------------------------------------------------------------##----------------###----------------------
-----------------------------------------##---------------------------------------------------------------------------------------------###-##-----------------------
-------------------------------------------------------------------------------------####------####---------------------------------------------###------------------
----------------####------#####-----------------------------######----##-----##-----------------------######-----------------##---#####------------------------------
--------------------------------------------------------------------------------######-------------------------------------------------------------------------------
--------------------------------------------#####--------------------------------------------------------------------------------------------------------------------
------------------------------------------------------------------------------------------------------------------------------------------------------------------##-
###########--####--####---------####--####----------------------------------------------#########-####------######----####-----####------------------------##########
