-------------------------------------------------------------------------------------------------------------------------------------------------------------------------------------------
------------------------------------------------------------------------------------------------------------------------------------------------------------###----------------------------
#-----###################################################----------#############################################-------####-----###########################-----###########################
#-------------------############################----------------------------------------------------------------------------------------------------------------################-----------
#-------------------############################-----------###----------------------------------------------------------#---------------------------------------################-----------
#-------------------############################--##------------###------------#---------------------------------------###--------------------------------------################-----#-----
#-----------------------------------------------------------------------------##--------------------------------------------###---------------------------------#-------------------##-----
#---------------------------------------------------------------#-------------##--------------------------------------------------------------------------------#-------------------##-----
#---------------------------#-------------#-##-----------------#-#------------##-------#--------------------#----------------------------------#-----------------###########--------##-----
#---------------------##########################--##--###---------#------#--######---#----#----------------##------###-####----------------#--##-----------------###########----##--##-----
#---------------------#####---##################------------------------##----##----##---##-------------##-##--###------------------#-----##--##----------##-------------------###--##---##
#---------------------#####---##################------------------------##----##----##---##------------###-##--###-----------------##-----##--##---------######---------------####--##---##
#--------------------------#####################------------------------##-#--##----##---##--------#-#-###-##--###-----------------##---#-##--##--------####------------##---#####--##---##
###########--##--#---####################################------##########################################--##--##------####------###############--#########-----#######################--##
