-----------------------------------------------------------------------------------------------------------------------------------------------------
-----------------------------------------------------------------------------------------------------------------------------------------------------
---------------------------------------------------##------------------------------------------------------------------------------------------------
--------------------------------------------#-----####-------------------#---------------------------------------------------------------------------
-----------------------##-----------------------------------------------###-------------------------##-----------------------------------------------
----------------------------------------------------------------------------#------#-#----###------####----------------------------####--------------
---------------------#----------#----###------#--------####--#---#---#------####------------------------#----#---------------###---------------------
-----------------######-------------------######------------###-###-###--------------------------------###-------------------------------------------
--------------------------###------------------------------------------------------####------------------------------------------------####----------
--------------------------------------####-----###--------------------------------------###-###----------------------##-#----------------------------
-------------#####-------------------------------#-----------------------------------------------------#----------############-----------------------
-----------------------------------------##########----------------------------####-------------###---#####------------------------------------------
--------------------------##---#######-----------------------------#------------------------------------------------------------------------------##-
###########--------------###--------------------------------################-----------------------------------###-------------------------##########
