--------------------------------------------------------------------------------------------------------------------------------------------------------------------------------
--------------------------------------------------------------------------------------------------------------------------------------------------------------------------------
------------------------------------------------------------------------------------------------------------------------------------------------#-------------------------------
--------------------------------------------------------------------------------------------------------------------------------------------------------------------------------
--------------------------------------------------------------------------------#-----------------------------------------------------------------------------------------------
--------------------###-----------------------------------------------------######----#----------------------------------------#####------------------------------##------------
--------------------------------------------------------------------------------------------------------------------------------------------------##-------------###------------
---------------------------------------------------------#---------------------------------------------------------------------------------------------#--------####------------
---------------------------------------------------------#-------------------#--------------------------------------------------#-------------##------##-------#####------------
--------------------------------####-------------------#####----------#----#######-----#---------------#-----------------------#####-----------------###------######------------
-----------------#---#-----------------#-----#---#-------------------##---------------##--------------##-----#------------#-----------#----#--------####-----#######------------
------------#--------#-------#--#------#---------#-----------#-------##---------------##---------#----##----##-----#-----##-----------#----#-------#####----########------------
------------#--------#-------#-------------------#-----------#-------##---------------##---------#----##-#--##-----#-----##-----------#----#------######---#########--------#---
##################################################################--#############################################################################-##############################
