------------------------------------------------------------------------------------------------------------------------------------------------------------------------------------------------------
------------------------------------------------------------------------------------------------------------------------------------------------------------------------------------------------------
------------------------------------------------------------------------------------------------------------------------------------------------------------------------------------------------------
------------------------------------------------------------------------------------------------------------------------------------------------------------------------------------------------------
------------------------------------------------------------------------------------------------------------------------------------------------------------------------------------------------------
-------------------------------------------------------------------------------------###------------------------------------------------------------------------------------------------##------------
--------------------------------------------------------------------------------------------------------------------------------------------------------#-------------------------------##------------
-------------------------------------------------------------------------------------------------------------------------------------------------------##-------------------------------##------------
-------------------------------------------------------------------------------------------------------------------------------------------------------##----------------------------#--##------------
----------------------------------------#------#-------------------------------#----#####-----------------------------------------------------####-----##---------------------------##--##------------
---------------------------------------##-----##----#--------------------------#----#--------------------------#------------------------------#----------------#-----------#----#--###--##------------
---------------------------------------##-----##------------------------------------#---------------------#----#------------------------------#-----------#---##-----#------------####----------------
----------#--#-##-------##-#-----#-----##-----##-----------###------##-#------------#-------------##-#----#----#---##-#--#------#----------#-##-----------#---##-----#-----------#####------------#---
############################################--#########################################----##################--####################################---################################################
