-------------------------------------------------------------------------------------------------------------------------------------------------------------------------------------------------------------------------------------------------------------------------------------------------------------------------------------------------------------------------------------
-------------------------------------------------------------------------------------------------------------------------------------------------------------------------------------------------------------------------------------------------------------------------------------------------------------------------------------------------------------------------------------
-------------------------------------------------------------------------------------------------------------------------------------------------------------------------------------------------------------------------------------------------------------------------------------------------------------------------------------------------------------------------------------
-------------------------------------------------------------------------------------------------------------------------------------------------------------------------------------------------------------------------------------------------------------------------------------------------------------------------------------------------------------------------------------
------------------------------------------------------------------------------------------------------##-----------------------------------------------------------------------------------------------------------------------------------------------------------------------------------------------------------------------------------------------------------------------------
---------------------------------------------------------------------------------------------------------------------------------------------------########------------------------------------------------------------------------------------------------------------------------------------------------------------------------------------------------------------##------------
-----------------------------------------------------------------------------------------------------------------------------------------------------------------------------------------------------------------------------------------------------------------------------------------------------------------------------------------------------------------------##------------
------------------------------------------------------------------------------------------------------------------------------------------------------------------------------------------------------------------------------------------------#--------------------------------#-----------------------------------------------------------------------------------#-##------------
-----------------------------#---------------------------#------------#--#--------#-----#--#------#------------------------------------------------------------------------------########-------------------------------##------------------#--##-------------------------------##--##------#----#-------------------##---##-----------------------------------------#-##------------
----------------------------##---------------------------------------##-----#----------##--------##-----------------------------------#-----------#----#----#---------------------------------------------------------------------------#--##--##------------------------------###----------------------------------------------------------------#----------------#-#-##------------
----------------------------##---------------------------------------##----##----------##--------##----------#-----------------------##-----------#------#--#-------#------------------------------------------------------------------##--##--##-----------------------------####---------------------------------------------------------------##----------#-----#-#-##------------
----------------------------##---------------------------------------##----##----------##--------##---------##-----------------------##-----------#---------#-----------#----------------------------------#---------------------------##--##--##----------------------------#####----------------------#---#------------------------------------##---------##---#-#-#-##------------
--------------#-##-------#--##----#-#---------------#---------##-#---##----##----------##--------##-#-##----##-#-----#----##-#-------##-----#-##--#---------#------------------------------------------##--#---------------------##-#--##--##--##--------##-#--#---------#--######----------------------#-#-#-----------------------#------#-##--##---------##---#-#-#-##--------#---
#######################################-#-##-##-##-###############################################################################################################-#-##-#-##-#################-#-#-###################------##########-##--##--############################################---##---################-----#----###################################-#-#-#-##############
