------------------------------------------------------------------------------------------------------------------------------------------------------
------------------------------------------------------------------------------------------------------------------------------------------------------
--------------------------------##--------------------------------------------------------------------------------------------------------------------
------------------------------------#--#--------------------------------------------------------------------------------------------------------------
---------------------####----------#######-------------####----------#------------------##--##--------------------------------------------------------
---------------------#####-----------------------------####----------#--#-------##---------------------------#-----##--------------------##-----------
---------------------------------------------##------------------------######------------------------#---------------------###-----------##-----------
---------------------------------------------------------------------------------------------------########----------------------------####-----------
------------------------------#####----------------------------------------------###---------------------------------------------------####-----------
-------------------########--------------------------------------###---------------------###-------------------####--####------------######-----------
--------------------------------------------------#####------------------------------------------------------------------------------######-----------
----------------------------#----------------------------------------------------------------####------------------------------------######-----------
-------------####----------###------------------------------------------------------------------------------###------------------#---######--------#--
###########----------------------------------####-----#####-#####-------------------------------------------###-------------##########################
