-SoSSSSSS--ESoS-
-SSSS------SSSS-
-###E------####-
-###E----SQ####-
##----------####
##----------####
####XXXXX---####
SSSS------SSSSSS
SSSS------SSSS--
SSSSX-SSSoSSSS--
SSSS------####--
SS-----------###
SS--QS-------###
SS-----------D##
