----------------
-----Q----------
----------------
----------------
----SSSS--------
----------------
--------S?SQ----
>-------------<>
]-------------[]
]-------------EE
X-----ESSSSXXXXX
X--oSSS---------
X---------------
X---------------
