SSSS------------
SSSS------------
SSSSS?SQ--------
SSSSXX-oo-------
----------------
----------------
--------XXXQ----
----------------
Q-------------##
#-------------##
###H-------H####
#MMMS?SQS?SMMM##
#--------------#
#--------------#
