---------------#
>-----------####
]---S?S?SQS#####
S-------------##
S-------------##
SSQS----------##
<>SSSS<>------##
[]SSSS[]S?S#--##
[]------------##
SS-----------###
SS-----------###
SS-----------###
SSoooo<>oooo####
SSSSSS[]SSSS####
