<>-----------###
[]-----------###
-<>SSSSS?--<###-
-[]SS------[###-
-[]SS------[###-
-SSQQ----SSSSSS-
----------------
----------------
-------S?oooSSS-
-ooQQ-----------
----------------
----------------
----S?SQ--------
----------------
