-------##SS-----
---QHHH---------
---####---------
---#------------
####---------SSS
----------------
-----------TSQS-
-------S?##-----
-------####-----
----SSS#--------
SSSSSSS#-------<
---------------[
---------------[
-------------SS[
