ooQS-----------o
---------<>SS--S
SS-------[]---XS
SS----EXXXX---X-
So------------X-
SSTTT---------#-
--------------##
---TT<>-------##
-----[]-------##
-----SSTTT----XX
----------------
----------------
---------TTSS---
----------------
