X--SS--ESSSSS--E
X------SSSS----S
XX-----SSoS--Q-E
##H----SSSS----E
##----<>-------#
##TT--[]-----T-#
------[]-------#
-----oT#-------#
-------#----TT--
---SS--#--------
-------#--------
------------T---
----QT---QS-----
----------------
