SQQQQQQE----SSSS
------------SSSS
------------####
------EXXXX#####
------[#--------
------[#--------
S?S?SSX#----TTTT
----------------
---------TTTT---
----------------
------####------
------##--------
---#####--------
---##-----------
