----------------
-----QS?SQQS----
----------------
----------------
---QSQS--TTSS---
----------------
----------------
------S?TT------
----------------
----------TToo--
----------------
----------------
---------TTTXXXX
----------------
