SS<>S-----------
--[]------------
--[]SSS---------
-----[]---------
-----XXS<>------
--------[]------
--------QS?[]---
-----------[]---
S?S?-------XXXXX
--So-----------S
--SS###--------S
-----##--------S
-----####E-----S
---------QS----S
