----------Q-----
----------------
----------------
[]----------####
[]----------####
XXXXXS?SQ---####
SSSS------SS####
SSSS------SS##--
####E-EEooSS##--
####------SS##--
##-----------###
##--QS-------###
##-----------D##
##-----------D##
