-------------###
-----------T-###
-------SSSSHHH##
-----Q-SSSS##-#-
----------------
----------------
SSS>------------
SSS]------------
SSSXXXXQ--------
SSSXXX-oo-------
----------------
----------------
--------XXXQ----
----------------
