##-----------XSS
-####S?SH--#XXX-
-####------#XXS-
-####------E###-
-####----SSS###-
#D----------####
SS----------####
SSSSS?SQH---####
####------######
####------####--
####H-H#######--
####------####--
##-----------###
##--TT-------###
