#------<SS#----#
##-----[SS#--T-#
##H----[SS#----#
##----SX-------#
##TT--SS-----T-#
------SS-------#
-----oSS-------#
-------o----SS--
---QS--S--------
-------#--------
#----##-------##
#TT--##----#####
#---H##D------##
#----##D------##
