SSSS------------
SSSSEooo--------
S---XXXXXoo#----
S-------QSS#####
S-----------####
S-------------<>
S-------------[]
S---Eooo------[]
S---XXXXXS?E--[]
##------TT######
#D----------####
#D-----------###
####S?STTT---###
####-----------#
