SSSSSoSSSSS#----
SSSSSSSSSSS#####
SSSS----------##
SSSS----------##
>-------------SS
]-------------SS
]-----<SSSSoooSS
]-----[SSSSSSSSS
SSSS-----SS##---
SSSS-----SS##---
SSSS--------####
SSSS-Q------####
S-----------####
S-----------####
