--------So------
--------SSTTT---
S?QS--------TTTT
----------------
----------------
---S?SQSS-------
----------------
--------SSSS----
----------------
SSSSSSSS----XXXX
----------------
----------------
-----oooQ-------
----------------
