[]--------------
XXXXX-----------
----------------
---S?SS---------
----------------
------SSSQ------
----------------
---------S?SS---
----------------
SSSS--------XXXX
----------------
---SSS#---------
----------------
------TTQS------
