----------------
--------S?ST----
----------------
--------------T-
----------------
----------------
-----<---#---Q--
--Q--[---#---S--
--#--[---#---S--
--#--[---#---S--
--#-E-----------
----------------
----------------
----XXXXQ-------
