----------------
##------S?SS?SQS
##------------<>
##------------[]
####----------[]
SoS>-----------<
SSS]-----------[
SoSSoSSSSSS#---#
SSSSSSSSSSS----#
####----------##
#D-------------S
#D-------------S
#####---EEEooooS
######XXXXXSSSSS
