----------------
----------------
S?S?SQS?S?SSSSSS
----------------
----------------
S?SS?SS?S?SS?SQS
----------------
----------------
SSS?SQSSSSSMMM##
S-------------##
#-------------##
###S?SSSSSSMMM##
##--------------
##--------------
