----------------
----------------
------QQQQ------
----------------
---SSSE---------
----------------
----------------
####------QS?SQS
#---------------
#---------------
#------?SQS-----
#---------------
##--------------
##--SSSE--------
