SoSS----------##
SSSS------######
----------------
----------------
SSSS?SSSSSSSSSSS
----------------
-E--------------
<>----------oooo
[]--------------
#H--------------
MMMSSSSQSSS#####
----------S#----
----------S#----
--#ooo----------
