SSSSSQSS?SQSSSSS
SSSS------------
SSSS------------
SSSS----E-------
--------#-------
--------#-------
--------#-T-----
----------------
----------------
MMMMSSSSSSSSSSSS
----------------
----------------
####----------SS
####----------SS
