##-----------###
##------------D#
####S?SQS-----<>
##------------[]
----------------
---------SS##---
----------------
----------------
##------Qoo#####
##------------##
##------------##
####----------##
####-----------#
####-----------#
