#---o--SSSSSSSSS
D--------------S
D--------------S
####XXXoo------S
####------------
S--------Q------
----------------
----------------
----SSSSSSQS----
-----------#----
-----------#----
<>----------####
[]--------------
[]--------------
