#####TT---------
----------------
------#SS#------
----------------
---------TTT#---
----------------
MMME--------XXXX
-----o----------
----XXX---------
----------------
------##TT------
----------------
---------T###---
----------------
