####--SSSS######
####--------####
####--------####
TTTTXX------####
####--------####
####--------####
####----TTTT####
####--------####
####--------SSSS
####SSSTT---SSSS
####--------####
####--------####
####-----TTTTTTT
####--------####
