-----H---H---E--
MMMMMMMMMMMMSSSS
----------------
----------------
---#------------
---#------------
-T-#---H--------
##XXXXMMTTTSSSSS
----------------
--------------#-
------------TTTT
--------------#-
----------------
---------E------
