]XX]--------SSSS
]XX]--XXX###SSSS
]XX#--------SSSS
XXX#--------SSSS
######------####
####--------####
####--------####
---###X--XXT----
---####---[###--
-######---[###--
---#####--#XXX--
----####--#XXX--
----####--#XXX--
----####-TTXXXXX
