----------------
---------TTT----
----------------
#-----------MMM#
#--------------#
#--------------#
##SSSSXXS------#
##-------------X
##--------XXXXXX
##-------------#
##-------------#
############---#
--##TT####-----#
---------#TTTTTT
