-------------###
#MMM##SSS----###
#-----SSSE-ETT##
E------------###
>-------------D#
]-------------D#
#-------------[]
#-------------[]
#-----EXXXXXXXXX
--------#HHHSSSS
----oMMM####----
SSX-------------
----------------
----------------
