XX<>--------XX<>
XX[]D#------XX[]
XX[]--------XX[]
##TT--------XX<>
##----E?Q?SQXX[]
##------------##
##------------D#
##HHH---#-----D#
####MMMM#?SQ####
----------------
----#--------b--
S?SQ#MMMMM#SSXSS
----------------
----------------
