----------------
--------S?S-----
----------------
----------------
?SQ---------#TT#
----------------
------------S?SQ
####------------
----------------
--TTTTTS??------
----------------
----------------
------------S?SQ
DT#H------------
