------TTT-------
---D###--T#H----
---D][]---<>[]--
-TTT][]---[][]--
---#XXXX--[][]--
----XX<>--[][]--
----XX[]--[][]--
----XX[]-#XXXXXX
----<>##--####--
----[]##--####--
----XXTTT-####--
----------####--
----------####--
---------TTT##--
