-----T#---------
----------------
---#-----#------
###T#T#T#?SQSSS?
----------------
--T--------b----
?SQT#S?SQSSXoooo
----------------
----------------
SS?MMMSS?SS?S?SQ
----------------
----H--------H--
oooMMMooooooMMMM
----------------
