----------------
---E------------
-E<>#-----------
----------------
----------------
####------------
####------------
####--###H------
####------------
#D-------------#
<>----------TTTT
[]-------------#
[]-------------#
XXXX#TT#TT#-----
