---SS?#---------
----------------
----------------
?SQooo#---------
----------------
------####------
----------------
---------TTQS---
----------------
MM##--------####
-----H----------
----TT#---------
----------------
------TT#T------
