----------------
---------###H---
----------------
----------------
MMSS?SMMMM#S?SQS
----------------
----------------
-#ooo-----------
----------------
----------------
-------T#-------
----------------
----------------
-----------#TT#-
