----------------
SSS?E?Q#--------
---------###H---
----------------
oooo--------S?SQ
----------------
----------------
-----#TT#-------
----------------
M#TT--------<>XX
------------[]XX
-----------X[]XX
-------##HXX[]XX
------#MMMXXXXXX
