ESMMME<>-----EXX
>---->[]T#--<>XX
]--H#][]E--####-
]-MMM][]QS----##
E-------------##
>-------------D#
]-------------D#
>-[---------####
]-[-----MMMM----
XXXS?SQS--##TTTT
----------------
---------------E
-H#S?SQS#----E<>
------------<>[]
