-------Q--------
----------------
---------#SQSSS?
----------------
------E?QS------
----------------
---###H---------
--------------H-
T###--------####
----------------
---------ESQS---
----------------
------S??S------
----------------
