----------------
-----H#---------
----------------
---H-----b------
T#MMMMMSSXSMMMM#
----------------
--H--------H----
T#S?SQS?SQSS?SQS
----------------
----------------
---------#------
----------------
-----T----------
-----------#----
