----------------
----------------
-#S?SQS#H-------
----------------
----------------
M#S?SQSS?SQS?SQS
----------------
----------------
-####-----------
----------------
----------------
-------#H-------
----------------
----------------
