#####T------<>[]
####--------[][]
####--------[][]
##----###?SQXXXX
<>------------<>
[]------------[]
<>###---T-----[]
[]#D--------SS[]
[]#D--------####
XX#####-----####
<>QS--------####
[]------------##
[]-----H##H---D#
XX------------D#
