----------------
---T------------
----------------
----------------
----##T#--------
----------TTT---
----------------
----------------
--------T#TT----
----------------
--T?SSSSM#------
----------------
----------------
###o------------
