----------------
S?SQ------------
----------------
----------------
------##H-------
----------------
---------#QS----
----------------
#-----------TTTT
#--------------#
#--------------#
##?SQ?SQS------#
##-------------#
D#--------TTTTTT
