TTT#------------
----------------
----------------
------#T#-------
----------------
----------------
----S?SQ--------
----------SQS---
----------------
----------------
--------T#QS----
----------------
--T####HMM------
----------------
