----####--D###--
----####--D###--
----D###-T#TTTTT
----D###--####--
----Eooo--#E<>--
----XXXXT-#>[]--
----------D][]--
----------DHHH--
---------T####--
-------H--------
----------------
---<>##--TTT----
---[]##---####--
-#TXX##---####--
