----------------
----------------
------S?S-------
----------------
----------------
----TTT#--------
----------SQS---
----------------
----------------
--------TTTT----
----------------
--S?SQ####------
----------------
----------------
