----D>----------
----D]----------
#####X-------###
------------##--
------#TT#--<>--
------------[]--
------------XX--
----------H#T#--
----------------
---H---D--------
MMMMM###?SQSQQ?S
----------------
----------------
-------#E-------
