---S[]<>--<>[]--
----[][]--[][]--
----[][]--[][]--
----[][]-EXXXXXX
----<><>--####--
----[][]--####--
----XX[]E-####--
----------TT##--
----------####--
---------TTT##--
-------H--------
S?SQM#MMMMMMMMMM
----------------
----------------
