EooSS###-------#
XXXE---###H----#
---------------#
-----------EH--#
---------------#
---------------#
-------------H##
---------------E
------EooEooXXXX
------##--------
------##--------
ESSESS##----ESSS
----------------
----------------
