ES-X-----------#
>--XESSS-------#
]--X-----------#
]-EX-----EE##--#
o--E-----------#
E-->----------##
XX-]----------##
E--<----------EE
>--[---EEooXXXXX
--##---[E-------
---#---[>-------
---#-SS[]-------
####---[]-----XX
####---[]---XXXX
