-----Eo--------#
-----XX###-----#
---------##----#
---------ES----#
---------------#
------------####
------------##--
---------Eo##H--
---------XX-----
------###-------
------##--------
---#####--------
---##-----------
---##-----------
