--------####----
--------####----
------H#####----
----------------
---###E---------
---##-----------
EE###-----EEEooo
----------EE----
-------EEXXX----
----------------
----EE##--------
----------------
----------------
--E-------------
