Eo##TT-EX-----Eo
XX##---XX-----XX
------T---##----
----------------
----------------
-----H#Eoo------
----------------
----------------
---####--EE##---
----------------
----------------
-------EE--ESSS-
----------------
----------------
