-----SS--EE-----
----------------
----------------
------E---##----
----------------
----------------
-----EEQQQ------
----------------
----------------
---EXXX--EETT---
----------------
----------------
-------#H--TTTT-
----------------
