----------------
-----E--E--#----
----------------
----------------
-------------#--
-------------#--
-------------#--
--DTTE--o--#-#--
--D--#--#--#----
--#--#--#--#----
TT#--#--#--T----
----------------
----------------
########--------
