----Eooo----####
EoooXXXXXEoo####
XXXX---E?XXX-###
E------------H##
>-------------##
#------E---T--D#
#---XXXXXHHH####
#--#H#######TTTT
##-#------------
##-#------------
#------Q-------#
#-T------------#
#--------------#
#------E-------#
