X--SS--E####T--#
X------S###----#
XX-----S###--T-#
##H----S###----#
##----##-------#
##TT--##-----T-#
------##-------#
-----TT#-------#
-------#----TT--
---TT--#--------
-------#--------
------------T---
----#T---TT-----
----------------
