----------------
-----#----------
----------------
----------------
----####--------
----------------
--------####----
#-------------##
#-------------##
#-------------##
#-----H#########
#--TMMM---------
#---------------
#---------------
