----------#-----
----------------
----------------
##----------####
##----------####
#########---####
####------D#####
####------D###--
####T-TT######--
####------####--
##-----------###
##--TT-------###
##-----------D##
##-----------D##
