##-----------###
##-----------###
-######TT--####-
-####------####-
-####------####-
-##TT----######-
----------------
----------------
-------########-
-####-----------
----------------
----------------
----###T--------
----------------
