-------------###
-----------T-###
-------####HHH##
-----#-######-#-
----------------
----------------
####------------
####------------
########--------
######-#T-------
----------------
----------------
--------TTTT----
----------------
