####------------
########--------
#---########----
#-------########
#-----------####
#-------------##
#-------------##
#---####------##
#---########--##
##------TT######
#D----------####
#D-----------###
#######TTT---###
####-----------#
