----XXXX--XXXX--
----XXXX--XXXX--
----XXXXX-XXXX--
----------####--
----------####--
---------TTT##--
-------X--------
XXXXXXXXMMMMMMMM
--------------#-
------------TTTT
--------------#-
----------------
---------X------
---------X------
