-------------XXX
XXXXXXXXX----XXX
X-----XXXX-XXXXX
X------------###
X-------------D#
X-------------D#
X-------------XX
X-------------XX
X-----XXXXXXXXXX
--------EoooXXXX
----XXXXXXXX----
XXS-------------
----------------
----------------
