---------X------
-----E---X---X--
XXXXXXXXXXXXXXXX
----------------
----------------
---X------------
---X------------
-X-X---X--------
####XXXXXXXXXXXX
----------------
----------------
---------XSS----
----------------
T-----------XXXX
