---------XXXX---
----------------
----------------
XXXXXXXXXXXXXXXX
----------------
----X--------X--
XXXXXXXXXXXXXXXX
----------------
----------------
-----TX---------
----------------
---H-----E------
XXMMMMXXXXXXXXXX
----------------
