----XXXX--------
----------TTX---
---------D------
---------D------
--------XTTT----
----------------
--EXXXXXXX------
----------------
----------------
XXXX------------
----------------
----------------
------XXE-------
---------XXXXXXX
