----------------
----------------
XXXXXXX---------
----------------
------XXXX------
----------------
---------XXXX---
----------------
XXXX--------XXXX
-----E----------
----XXX---------
----------------
------oXXX------
----------------
