----------------
---------XXXXXXX
----------------
------XXXX------
----------------
---XXXX---------
--------------X-
XXXX--------XXXX
----------------
--------BXXXX---
--------b-------
------XSXX------
----------------
---XXXX---------
