XXXXXXX---------
----------------
------XXXT------
----------------
---------TTTX---
----------------
XXXX--------XXXX
-----o----------
----XXX---------
----------------
------XXXX------
----------------
---------XXXX---
----------------
