-----E---E---E--
XXXXXXXXXXXXXXXX
----------------
----------------
---X------------
---X------------
-X-X---E--------
XXXXXXXXXXXXXXXX
----------------
--------------#-
------------TTTT
--------------#-
----------------
---------X------
