----------------
---------XXX----
----------------
E-----------TTT#
>--------------#
]--------------#
]EXXXXXXX------#
XX-------------X
XX--------XXXXXX
XX-------------#
XX-------------#
XXXXXX######---#
--XXXX####-----#
---------#TTTTTT
