--X--------H----
XXXXXXooooMMMMMM
----------------
----------------
###MMMXXXX######
----------------
----H--------X--
###MMMXXXXXXXXXX
----------------
----------------
-----TT---------
----------------
---H-----H------
XXXMMMMMMMXXXXXX
