#-----#-------##
#--#-###--------
----------------
#-##------#-----
##-------------#
###---------####
#--#-##--------#
#----###-------#
---#------------
#--------------#
---------##----#
---------------#
------#####-####
-----#----------
----------------
####--##------##
##-#---------#--
----------------
----------------
-------------#--
--------------#-
-------#--------
----------------
-----#---##-----
----------------
----------------
----------###---
----------------
--###-#---------
----------------
----------------
-----------#----
----------------
----------------
#---------------
#---------------
##-#------#----#
-----------#---#
----#-----------
#---------------
##--##----------
##-----------###
##-----------#--
####---------###
####-----######-
##--------------
-#-----##----##-
----------------
###-----###-##--
----##------##--
-------------#--
-#----------#-#-
-#------------##
----------------
-#--------#-#---
-----#----------
--#-#-----------
---##-----------
--#----#---#----
-------#--------
------##--------
-#--------------
----------------
-----#----#-##--
---#-----####---
----------------
----------------
-------------#--
----------------
----------------
----------------
----------------
----------------
----------------
----------------
----------------
---------#------
----------------
----------------
---#----#-------
----------------
##---------#####
---------------#
#---####--------
#--------#######
----------------
----------------
---------####---
----------------
-------##-------
-#---------###-#
----------------
------##-----#--
----------------
---#------------
-----------#----
-------###-#---#
----------------
#-###-----------
----------------
---#-#-#--------
####---##-------
-------###------
----------------
------#---------
----------------
----------------
------------##--
----------------
-----#----------
----------------
----------------
---#-----------#
--##-------#---#
----##---------#
--------------#-
------#--#######
----####--------
------##--------
---#####----#--#
----------------
----------------
----------##----
-------#--##----
------##--#-----
----------------
---#------------
---#---------#--
#-----------#-##
##-#--#--#--####
#--#--------####
#-------#---####
--#----------#-#
##----####------
#----######-#--#
-#----####-----#
#####-----#-##-#
---------------#
---------------#
---------#--###-
------##--------
----------------
---####---------
-##-##----------
----------#-----
---------------#
----------------
----------------
#--#-----------#
#--#------#---##
#---------------
#--#------------
#--##---#--#----
#---------------
----------------
----------------
----------------
----------------
--------------##
#--------------#
