---#-----##-----
---------------#
##-#--------####
#-------------##
#---------------
#---------------
----------------
#---------##----
##--------------
#--------------#
##--------------
-#--------------
---------------#
----------------
---#------------
---#----####----
##-#-----------#
---------------#
-------#-------#
---------------#
---------------#
----------------
----------------
-----#------##--
---------------#
----------------
----------------
---#------------
-------------#--
----------------
-------##-#-----
---------##-----
--------------##
----------------
----###-##------
----------------
----------------
----------------
#---------#-##--
----------------
----------------
---------###----
----------------
--#----#######--
---------------#
----------------
----------------
---#-#----------
-------#--------
----------##----
----------------
########--------
######-##--#-#-#
-#-----#--------
----------------
---------###----
----------------
-------##-----#-
--------########
--------##----#-
#---------------
#--------------#
#-##---#-------#
#--------------#
----------------
----------------
----------------
----------------
----------------
------#---------
##------#####---
--------------#-
------------#---
#---------------
-------------#-#
##--------------
##-----------#-#
-------------#--
-------------#--
-------------#--
--#-#-----------
---#--------####
----------------
----------------
----------------
---#------------
----#-----------
----------------
##---------#----
##--------####--
####---#----####
-#-------------#
-#######--------
#####----------#
---------------#
#--------#--####
----------------
------------##--
---------#------
#---------------
-------#--#-----
#---#-####------
----------#-----
###-------------
#--#------------
####------------
####------------
--######--------
---#------------
-###------------
-###------------
--------------#-
---------##-----
----------------
----------------
-------###------
----------------
-----#---#------
-----###--------
#----#-----#----
----------##----
----------------
----------------
-------------###
----------------
----####---#----
------#--#------
----#----##--#--
#-#---------#-#-
----------------
#----------#----
##------------##
#-----##-#------
----------------
----------------
##-#----------#-
--------------##
----------------
--------#-----##
----------######
----------------
-------####-----
------#-##------
--######------#-
-#####----####--
----------------
----------------
------------#---
----------------
---------#------
-------#-###----
----##----------
----#-----------
----------------
----------------
----------------
---------#------
----------------
-----#----------
-----#----###---
