#--#-----#------
#--#------------
###------------#
#----##---------
#---------------
#--#--#---------
----------------
---#-----###--##
--------------##
---#-------#--##
--##-----------#
--#####--------#
---------------#
---------------#
-#-##--#-##--#-#
###-----###--#-#
----------------
---#------------
----------------
--####-###------
---###----------
----------------
------#-####---#
----------------
----------------
----------------
--------##------
----------------
----###---------
##--########--##
--##------------
####---##--#---#
---#-##----#----
----------------
----#-----------
--------####----
--------#-#-----
-------##-------
---------#------
----#-----------
----------------
----------------
#-----#---------
----------------
-----------#-###
----------------
----------------
----###--#------
----##----------
----------------
----------------
####---------#-#
-------#-------#
----------------
------#-#-------
------###-------
-------##-------
----------------
--###-----------
-------#--------
----------------
----------------
-------#--------
------##--##----
##-------------#
##--##---------#
###-------------
---------------#
----------------
------------##--
-------------#--
------------##-#
------------#---
----------------
----------------
----------------
---##--#--------
---#-----#------
----------------
--------------#-
#------#-#------
----------------
----------------
----------------
----------------
####---#-------#
--------##-----#
---------------#
----------------
------#--#-#----
-----------#----
-------------###
-----##-----##-#
---####---------
-----------#----
#-#--###-#-##-##
##----------####
#-------##--####
#------#----####
---##-#---------
--#-##----------
###----------##-
##--------------
----------------
----------------
----------------
----------------
----------------
--------##------
----------------
----------------
-------------##-
------##--------
------#---------
----------------
------#---------
#-##-##----#----
------#----#---#
--#---###--#---#
-----###-#-#----
-----####-------
----##----#-#---
----------####-#
-------------#--
------##-------#
-------#------##
------##-----#-#
-------#----####
##-#--------###-
##-#-------##---
-------#--------
----------------
-----#-------#--
----####--------
----------------
----#----#------
----------------
---##----#######
----------------
----------------
-----------#----
---####---------
----------------
------##-#--##--
-------#------##
----###--#----##
--------------##
--------##------
----------------
--------####----
----------------
------------####
##------------##
--------------##
---#####------##
---------------#
----------#-#---
----------------
----------------
--------------##
