-----------#----
--------#-------
----------------
--------#-------
---######-------
----------------
----------------
----------------
----------------
----------------
--------#---#--#
--------------#-
----------------
##----#-#-------
#----------#----
#-#------#------
-----------#-#--
---------#-#----
----------#-----
-#--------------
----------------
-------###------
-----#----------
---------#--#---
--#---------#---
--#----------###
---#---------#--
--#######-------
--------#-------
----------------
----------------
--------#-------
------------###-
----##------####
------------####
----#----#-###--
------------#-#-
------------#---
------------#---
-###-#-----#####
------------##--
-------------#--
------------##--
----------------
--###-------##--
------------##--
----------------
--------##--###-
######-####-#--#
#--------------#
##-------#-----#
-#-----#-###-#-#
---------------#
##-------------#
##-#-----------#
#---####-------#
##-----------#-#
----------#----#
---------------#
---------------#
-------------#-#
------##--------
-----------#---#
---###---####-##
--------#------#
--#----###------
--##------------
---#-###--------
-###---#--------
#####--#------##
#####--##-----##
##--------#-#--#
---------------#
----------------
----------------
----------------
-------##-------
-----#----------
-----#----------
-#####----------
##-###----------
-------#--------
---#-#----#-#-##
---------------#
--------##------
----------------
------#--#######
----------------
----------------
--####-------###
----#-----------
--------###-----
----#####-------
----####----##--
----#------#----
----####-------#
##-###-#-####---
----------------
----#-----------
------------#---
----------------
-#--------------
####---#########
-#--------------
-######---------
----------------
----------------
-------##-----##
---------#------
----------------
---------#------
----------------
#-----#--------#
--------###-#---
----------------
-------#------#-
-#----------##-#
#---#-----------
----------------
----------------
---#####--------
----------------
-------####-----
---------#------
---------###----
----------------
---#------------
-------------#--
######----------
####------------
####-#----------
----------------
----------------
----------------
-----#----------
----------------
-#-------------#
----------------
----------------
#-------##------
##-------#------
####----##---###
##-#----------##
---######-----##
##-#-###----#---
----------------
----------------
----------------
-------#--------
------##--------
---##-##--------
----------------
----------------
#####-----------
----------------
----------------
-----##---------
---------#------
----------------
-#-##-##-#-##--#
