---------#--####
------------###-
-----###--####--
-----#----#####-
----##----------
----##----------
-----------#----
------#---------
----#--#--------
---#####----##--
----------------
----------------
---------#####--
----------------
----------------
---------#----#-
----------------
-----##-##-#---#
---#--------####
--------------##
--------------##
----------------
----------------
--------####-#-#
#--------------#
#--#####-------#
#------#-------#
--##-----------#
----------------
---------------#
#-##----------##
--##----------##
#-----#-###-####
---###-#--------
---#------------
#-####-#--------
---#-----------#
----------------
---#--###-------
-------#------##
---##-##--------
---------------#
--------------##
#-------#-----##
#---------------
#--#-----------#
#--#-----#---#-#
----------------
----------------
------###----#--
----------####--
----------####--
----------####--
----------------
----------------
-------#--------
----------------
----------------
---------#------
----------------
-----#----------
---#------------
----------------
----------------
-----##--#-----#
--------##------
----------#----#
----------###-##
------------###-
----------------
----------------
-------#-##-----
------##--------
----####-#------
----------------
----------------
---#------------
---------#------
----------------
------##-#######
----------------
--#####---------
---------#------
---------#------
----------------
------##--------
------#---------
---#####-----#--
----------------
#------------#--
--------#----#--
----#-----------
----------------
--------------#-
----------------
---------#------
--###-----------
--##-#----------
--#--#----------
-----#--#-------
--------#-------
----------------
----------------
----------------
#--#----------#-
#-##----------##
#--#-------#---#
#------####----#
#------##------#
#-----######---#
#------#-------#
##-#####-----#-#
------##-####---
----------#-----
----------------
----------------
---#-#----------
---###-----#----
---#-####-------
----------------
----###---------
----------------
-------------#--
--#-----#--###--
------------#---
-----------#####
-------###------
----------------
----------------
####------------
-------------#--
----------------
-----#----------
----------------
--------#-------
--------###-----
----------------
---####---------
----------------
---####---------
---#------------
####-----#------
----------------
--#-------###-#-
#---------------
----------------
---#------------
#-------------#-
#---------------
#--------------#
#-##-----------#
--------------##
#--------------#
##------------##
#--#----#--#--##
#--------------#
#--#----------##
#-------#------#
---------------#
##------#-##-##-
