#--------#-#----
----------------
---------------#
--####---------#
--#------------#
##########--#--#
--##-------#----
---#------------
----------------
------------####
-----------###--
-----------#----
---#--#---######
-----###--###---
------#---##----
#---#####-####--
---#-------##---
----------------
---------------#
----------------
----#-----------
----------------
----------------
----------------
---------#-###-#
----------------
----####--------
---------######-
----------------
-------###------
----------------
---####---------
----------------
---#------------
-------#-#-###-#
------#-----##--
-#----##--------
------##----#--#
---#--#---------
------------#--#
----------------
---------------#
#--#---#-##-##--
#------#-------#
#------#--#--###
#--#-#######--##
---#----------##
-------#--#----#
####----------##
#--#-----------#
---------------#
###---#-####--##
----------------
-------------#--
#########--#----
----------------
----------------
------#---------
------#--#------
------#---------
-----###--------
-----------#----
#--#-----------#
----------------
###-####-------#
---------------#
----------------
#####-#--------#
----------------
----------------
-------#-------#
----------------
----------------
#----#----------
#----#-----#-#--
##----------##-#
#--------#--##-#
----##--#####--#
----------------
------#######---
------------#---
-----------###--
----------------
--####---#####-#
--##-#----------
-##-##---------#
---###-##--#---#
-----#---------#
----##---------#
----------------
---------------#
-------#-#--#---
-----------##---
-------------#--
--------###-----
----------------
--#-----##------
####-----#------
----------------
--######--------
----------------
----------------
####-----------#
##-#----------##
#-------------##
#-----------####
#---------######
#-----------####
#---------------
#------####-#---
##----##-------#
##----###------#
--------------#-
#---------------
----------------
----------------
-#--#-----------
----#-----------
-----###--------
#######------###
----------------
---------#------
---------#------
----------------
------------#---
--##-----------#
----------------
-------------#--
##--------------
######----------
#-------#-------
----------------
####----#-----#-
----------------
----------------
-----##-#-#-----
----------------
------------###-
----------------
--##--------####
--####--------##
--##-#---------#
----------------
-------##-------
------#--##---##
------#---#-----
----#-----#-##--
----####-----#--
------#-----#---
------#---#-##--
------#--##-----
------#-##-#----
------####------
---#--#-#-------
---#------###---
---#------#-----
##-#--------##--
--##------------
--###-----------
------#---------
