#########--#####
----------------
--------##------
----------------
----------------
----------------
--------------##
-----#--#----#-#
-----#--------#-
---------#------
---------#------
----------------
#-----------####
----------------
----------------
--#######---#-##
---#------#---#-
----------#-----
----------------
-#-------------#
-----#----------
-----#----------
----------------
---#---#-##-----
---#------------
-#------------##
##----------####
##----------####
#------------###
------########-#
-#-#-------#----
------##--####--
#--------#---#-#
#--------------#
###------------#
----------------
---------------#
------------###-
----------------
----------------
-------------#--
---------#------
----------------
----------------
-#####-#--------
-----------##--#
----------------
-------#--###---
#---------------
##--###---------
#---------------
---------------#
--##----------##
------#-------##
------#-------##
-------#########
----------------
----------------
-------###--##--
###---#---------
--------------##
-----##-------##
------#-#----#-#
--------------##
---------##-----
---------#####-#
---###--##--####
--#--#-------###
----#-----------
----------------
---###---------#
---------##----#
---------##--#--
------##-#-#-#--
---------##-###-
------#---------
----------------
------#---------
---#-#----------
----------------
##-----#-#######
----------------
--------------#-
##--------------
----------------
##-----##--###--
-#--------------
----------------
----------------
----------------
---------###----
----------------
-----#----------
------------####
----------------
----#######-#---
---------#####--
----------------
----------------
#-######--##----
##-#------------
----------------
------#--###----
----------------
------##--------
-------#-----#--
-----#----------
---####---#-#---
----------#-##--
----------####--
----------####--
-------###-#----
------########-#
----------------
----------------
----------------
-------------###
---------------#
-------#####----
----------------
----------#-----
----##----------
---#------------
---#------------
----------------
----------------
----------------
--------#--#--#-
----####---###--
----####-#--##--
----------#-----
------#---------
----------------
------####------
------#---------
-----##-#####---
----------------
#--####---------
-------#--------
-------#--------
#####-----------
-----##-##--####
----------------
---#--##--------
---------####---
----------###---
------------#--#
####--------####
---#-#------####
----------#--###
---#--######---#
---#-----##-----
----------------
#---#-----------
####---------###
#------------###
---#-----#--#-##
---#--####--#-##
---#----------##
--##----------##
