--#-#----#####--
----------###---
-----------#----
--####-------#--
----------------
----------------
-----#####--##--
----------------
----------------
-##----##--###--
------------##--
------------##--
--##----######--
-----------##---
##-----------#-#
-###--###-##----
--#-------#-----
----------------
----------------
-----#----------
-----#----------
----------------
----------------
-----------#----
---------#---#--
-----#----------
----------------
----------------
----------------
----------------
----------------
#---#------#----
##-----#-##-####
##--------------
--------------#-
-----------#--#-
---#------------
----------------
----------------
-#--------------
---#------------
--------#-------
----------------
-------##-------
#---------------
##------------##
#-#######-----##
--------------#-
##------------##
--------------##
------------#-##
------#-##-----#
----------------
---------##-----
#--------------#
##-----------#--
###-----------##
#---###--------#
----------###---
---------#------
------#####----#
----------------
----------------
#######--------#
--#####-----##--
-----#-------#--
--#----##----#--
-----------#----
----------------
--------#-#-----
----------------
----------------
----------------
-##--#----------
----------------
----------------
----------------
----------------
--------#-------
------------#--#
####-#----#-####
------------####
------------####
----#####---##--
-#-----------#--
-##-------------
-#---#----------
------------##--
----------------
------###-------
-----------##---
---------#------
--------#-------
----------##----
---#----------#-
------####----#-
-----######-----
---------##-----
----------#-----
----------#-####
--------------##
---------------#
-----------#####
-------#--------
--#---##--------
----------##----
---------------#
--###--------#--
----------------
----------------
----------------
----------------
#------###-----#
#---------------
----------------
#--#------------
##-#----------##
##-------------#
########------##
#--#------------
#---------------
-#--------------
----------------
---#---#------#-
--########----#-
####--------####
#-#------------#
####-------###-#
------###----###
---------------#
----------##-#--
----------------
----------------
-#-----#--------
----------------
----------------
----------------
----------------
----------------
---------#------
-----#---------#
-----#----------
----------------
---------------#
#--------#####--
----------------
----------------
-----------#####
-#-----------#--
-#####------####
------------####
--###-#-----####
----------#-###-
----------------
----------------
------------#---
----##--##------
----------------
----------------
---##--#-##--#--
