####---#--------
----------------
----------------
--------##------
---#----###-----
----------------
---#-#----------
######----------
--#------------#
------------#---
--------#-------
--------##------
------####---#--
----####--------
----------------
----------------
#---------##-###
#---#####------#
#---#--#-##--#--
#---------------
######----------
#-----------#---
##-#---------#-#
--------------##
------------####
-------------###
-#--------------
--------------#-
----------------
##-------#------
#---------------
#-----####------
--#------##--#-#
------####-----#
#-#---###------#
####---#-------#
---------------#
#--#--#--#-----#
---------------#
------##-------#
------##-----#-#
---#------------
------#---------
-----###--------
##-#-#--------##
#---####------##
#-----#-------##
#-###--#--######
--------#-------
--------------##
######------####
---------#-----#
---------------#
------########--
----------##----
#-##------##-#--
--##-#----#-###-
-------------###
-------------###
-------------###
---------#--###-
----------------
------###----#--
----------------
##------------##
##--------------
----------------
---#------------
--------##------
-----------#----
#------------###
---#------------
----#-----------
------#---------
----------------
----------##----
----------------
----------------
----------------
-----#----------
--------------#-
----------------
##---#----------
-----#----------
----###-##------
---------#------
---------#-##---
----------------
----------------
-----#----------
----------------
--------#####---
----------------
-------#-----#--
--##--#-----#-#-
-----##-----##--
####----------#-
--##---#########
-------------##-
---####---------
----------------
----------------
----------------
----------------
#--------#--##-#
#--------------#
##--------------
##---------#####
---------------#
-----#-#-------#
-##-------------
--------------#-
---#-----##-----
#--#------------
#-------------##
#########--#-###
-----------###--
---##------#----
---#-------#----
----------------
---#------------
####------------
--#####-####----
---#-#----------
----------------
---------###----
---------------#
####---#########
--########------
----------------
####----------##
--#--------#---#
---------------#
----------------
-----###--------
-------#--------
---#------------
---------###----
----------------
##---#-------###
#--#--#--------#
----------------
--#--------#----
----------------
----####--------
----##-#--##---#
----------#--##-
-#-##----------#
---##--##----##-
----------------
----------------
---------####---
---------------#
----------------
------##---#----
----------------
--###-----------
---------####--#
--------------##
---#--##--------
