----------------
---#------------
-####-----------
----------------
----------------
####------------
####------------
####--####------
####------------
##-------------#
##----------TTTT
##-------------#
##-------------#
###########-----
