----------TTTTTT
-------####-----
-------TTTT-----
---------------#
-#TTT--------###
##----------####
----------------
------##TT------
########--------
----------------
------------####
----------------
--------####TTTT
----------------
