----------------
-----TT---------
----------------
---H-----D------
##MMMMMTTTT#####
----------------
--H--------#----
################
----------------
----------------
---------#------
----------------
-----T----------
-----------#----
