----------------
----------------
----####--------
----------###---
----------------
----------------
--------####----
----------------
--TTTTT###------
----------------
----------------
TTTT------------
----------------
----------------
