-------S--------
----------------
---------#######
----------------
------SS##------
----------------
---####---------
--------------H-
####--------####
----------------
---------####---
----------------
------TT##------
----------------
