-----##---------
----------------
---#-----#------
TTT#############
----------------
--T--------#----
################
----------------
----------------
###MMM##########
----------------
----H--------H--
###MMM######MMMM
----------------
