-----------####-
----------------
----------------
-########-------
----------------
----------------
####--------####
####--------####
#######-----####
####--------####
##------------##
#D-----#TT#---D#
#D------------D#
####--------####
