----------------
########--------
---------####---
----------------
####--------####
----------------
----------------
-----####-------
----------------
####--------####
------------####
-----------#####
-------#########
------####TTTTTT
