---####---------
----------------
----------------
#######---------
----------------
------TTTT------
----------------
---------TT##---
----------------
###X--------####
-----o----------
----XXT---------
----------------
------TT##------
