######------####
####--------####
####--------####
##----##########
##------------##
##------------##
#####---#-----##
###D--------####
###D--------SSSS
#######-----SSSS
####--------SSSS
##------------SS
##-----TT##---SS
##------------SS
