------TTT-------
---D###--T##----
---D###---####--
-TTT###---####--
---#####--####--
----####--####--
----####--####--
----####-#######
----####--#XXX--
----####--#XXX--
----##TTT-#XXX--
----------#XXX--
----------#XXX--
---------TTXXX--
