ESMMMXXX-----XXX
>----XXXXX--XXXX
]--H#XXXE--####-
]-MMMXXXSS----##
X-------------##
X-------------D#
X-------------D#
]-X---------####
]-X-----####----
XXXXXXXX--TTTTTT
----------------
---------------X
-ooSSSSSo----EXX
------------<>XX
