XXXX--------XXXX
XXXXXX------XXXX
XXXX--------XXXX
XSSS--------XXXX
XX----SSSXXXXXXX
##------------##
##------------##
##HH#---H-----##
#####MMMMSSSTTTT
----------------
----E--------E--
SSSSXXXXXooSSSSS
----------------
----------------
