---SSSo---------
----------------
----------------
XXXoooX---------
----------------
------XXXX------
----------------
---------XXoo---
----------------
SSSX--------XXXX
-----o----------
----XXT---------
----------------
------##XX------
