----------------
---E------------
-SSSX-----------
----------------
----------------
####------------
####------------
####--XSSS------
####------------
##-------------#
XX----------TTTT
XX-------------#
XX-------------#
XXXXXXXXXXX-----
