-------S--------
----------------
---------oSSSSSS
----------------
------SSoo------
----------------
---oSSS---------
--------------E-
oooo--------SSSS
----------------
---------XSSS---
----------------
------ooXX------
----------------
