-----------XXXX-
----------------
----------------
-XXXXXXXX-------
----------------
----------------
XXXX--------XXXX
XXXX--------XXXX
XXXXXXX-----XXXX
###S--------####
##------------##
##-----ooo#---D#
##------------D#
#TTS--------####
