----------------
SSS?SSSX--------
---------oXXX---
----------------
oooo--------SSSS
----------------
----------------
-----XXXX-------
----------------
ooSS--------<>XX
------------[]XX
-----------X[]XX
-------XXXXX[]XX
------SXXXXXXXXX
