----------------
----------------
----oooo--------
----------XXX---
----------------
----------------
--------oooo----
----------------
--SSSSSSSS------
----------------
----------------
ooQQ------------
----------------
----------------
