----------TTTTTT
-------####-----
-------TTTT-----
---------------#
-ESSS--------###
SS----------SSSS
----------------
------XXoo------
XXXXXXXX--------
----------------
------------####
----------------
--------SSSSTTTT
----------------
