----------------
-----oo---------
----------------
---H-----E------
ooMMMMMSSSSMMMMM
----------------
--H--------H----
ooSSSSSSSSSSSSSS
----------------
----------------
---------o------
----------------
-----o----------
-----------X----
