----------------
----------------
-XXXXXXoo-------
----------------
----------------
ooSSSSSSSSSSSSSS
----------------
----------------
-oXXX-----------
----------------
----------------
-------oo-------
----------------
----------------
