----------------
--------Q-------
----------------
--------T-------
----------------
----------------
>-----TTTo-oS?SQ
]---------------
]---------------
]----------D#---
>----------D#--#
]-----###S?###-#
]-----##-------#
]--S?###-------#
