----------------
-----Q--Q--#----
----------------
----------------
-------------#--
-------------#--
-------------#--
--DTTQ--Q--#-#--
--D--#--#--#----
--#--#--#--#----
TT#--#--#--Q----
----------------
----------------
########--------
