--------###S----
--------###S----
------#####S----
----------------
---###Q---------
---##-----------
S?###-----S?S?SQ
----------[]----
-------S?SXX----
----------------
----S?QS--------
----------------
----------------
--Q-------------
