---#------------
###-----------<>
####S?SSQS----[]
<>------------SS
[]------------SS
##----QS?SQoooSS
##------------<>
##------------[]
##TT###Q------[]
##----#SSSS---##
##------------##
##------------##
#####-------####
#######oooo#####
