S--S------QSSSSS
S--S----------SS
SS-S----------##
>--SS---------##
]-->----------##
#-T]----------##
#--]-----EE##-##
#-->----------<>
#T-]----------[]
#--####Q------[]
X--#----------##
X-S#-----------#
X--#----S?S#---#
X--#-----------#
