-----S?--QQ-----
----------------
----------------
------E---SS----
----------------
----------------
-----EEQQQ------
----------------
----------------
---QXXX--EETT---
----------------
----------------
-------QS--TTTT-
----------------
