SS##----------SS
SS##----------SS
SS##----------SS
SS##----S?ooooSS
---#-#----------
---#------------
<>#-----------<>
[]####S?SQ----<>
[]------------[]
SS------------##
SS----E?SQ######
SS------------##
SS------------##
SSXXXXXE------##
