----Eooo----####
SSSSXXXXXSSS####
SSSS---S?SSS-###
>------------T##
]-------------##
#------?---S--SS
#---SSS??ooSooSS
#--#S?SQSSSSSSSS
##-#------------
##-#------------
#------Q-------<
#-T------------[
#--------------[
#------E-------[
