SS-S-----------<
S--SS?SQ-------[
S--S-----------[
S-oS-----S?##--#
>-->-----------#
]--]----------##
]E-]----------##
S--S----------SS
S--S---QS?SoooSS
--##---[S-------
---#---[S-------
---#-SS[S-------
####---[S-----XX
####---[S---XXXX
