----------------
-----Qo--oQ-----
----------------
----------------
--S?------------
--SSSS>---------
-----S]---------
-----S?SSS------
--------SS------
--------SS###---
-----------##---
S?<>-------#####
--[]-----------#
--XXXXX--------#
