SoS??###-------<
SSSS---#SQS----[
---------------[
-----------QH--#
---------------#
---------------#
-------------H##
---------------E
------S?SS?SXXXX
------SS--------
------SS--------
S?SS?SSS----S?SQ
----------------
----------------
