-----So--------<
-----SSSSS-----[
---------So----[
---------S?----#
---------------#
------------####
------------##--
---------<>SQS--
---------[]-----
------SSS-------
------SS--------
---###SS--------
---##-----------
---##-----------
