XXMMMMME----####
------------####
------------####
------#XXXX#####
------##--------
------##--------
XXSSS###----TTTT
----------------
---------TT##---
----------------
------####------
------##--------
---#####--------
---##-----------
