X--SS--EXXXXT--#
X------SXXX----#
XX-----S###--T-#
##H----S###----#
##----<>-------#
##TT--[]-----T-#
------[]-------#
-----ST#-------#
-------#----TT--
---XX--#--------
-------#--------
------------T---
----XT---TT-----
----------------
