####-----------#
---------####--#
##-------##---XX
##----#####---X-
##------------X-
TTMMM---------#-
--------------##
---TT##-------##
-----TT-------##
-----TTTTT----XX
----------------
----------------
---------TTSS---
----------------
