----------?-----
----------------
----------------
##----------####
##----------####
TTTTTM##X---####
####------[]####
####------[]##--
####E-EEXXXX##--
####------XX##--
##-----------###
##--XX-------###
#D-----------D##
#D-----------D##
