---------------#
E-----------####
>---TT##########
#-------------##
#-------------##
####----------##
XX##HH#H------##
XX####MMXXX#--##
XX------------##
##-----------###
##-----------###
##-----------###
######EE########
##TTTTXX########
