---------MM----#
---------------#
X-----------#HHH
X---XXXXXXX#####
#-------------##
#-------------##
####----------D#
####H##H------##
#####MMMM##T--##
##------------##
[]-----------###
[]-----------###
[]-----------###
XXXTTTXXXTT#####
