----------------
-----#####oo----
----------------
----------------
---?TTT--##XX---
----------------
----------------
------SSTT------
----------------
----------TT##--
----------------
----------------
---------TTTMMMM
----------------
