-XXX####T--####-
-XXX#------####-
-###E------####-
-###E----XX####-
##----------####
##----------####
####XXXXX---####
####------D#####
####------D###--
####X-SSSTT###--
####------####--
##-----------###
#D--TT-------###
#D-----------D##
