####------------
########--------
#---#####TT#----
#-------XTT#####
S-----------####
S-------------<>
S-------------[]
S---Eooo------[]
S---XXXXXTTX--XX
##------TT######
##----------####
##-----------###
####MMMTTT---###
####-----------#
