#------####----#
##-----#TT#--T-#
##H----#TT#----#
##----##-------#
##TT--##-----T-#
------##-------#
-----###-------#
-------<----XX--
---TE--[--------
-------#--------
#----##-------##
#TT--##----#####
#---H##D------##
#----##D------##
