----------------
----------------
oooooooooooooooo
----------------
----------------
oooooooooooooooo
----------------
----------------
oooooooo###MMM##
X-------------##
#-------------##
###oooXX###MMM##
##--------------
##--------------
