----------------
----------------
------XXXX------
----------------
---oooX---------
----------------
----------------
####------oooooo
#---------------
#---------------
#------SSSS-----
#---------------
##--------------
##--oooo--------
