#---o--ooooTTTT#
D--------------#
D--------------#
####XXXXX------#
####------------
o--------o------
----------------
----------------
----oooooooo----
-----------#----
-----------#----
##----------####
##--------------
##--------------
