--------oo------
--------SSTTT---
oooo--------TTTT
----------------
----------------
---ooooo#-------
----------------
--------###o----
----------------
oooooSSS----XXXX
----------------
----------------
-----oooo-------
----------------
