----o----oooo---
----------------
----------------
--o###-----TXXX-
--------D-------
--------D-------
------#TTT------
----------------
----------------
--Tooo----oooo--
----------------
----------------
TTTX-------ooooo
----------------
