###D--------####
###D--------####
####TTT-----####
####------o-####
#D----------oooo
##----------SSSS
##----oooooooooo
##--------------
#D--------------
##TTTT----------
##--------------
----------------
-----TToo-------
----------------
