----------------
##------oooooooo
##------------##
##------------##
####----------##
oooo-----------o
SSSX-----------X
ooooooooooo#---#
SSSSSS?SSSS----#
####----------##
#D-------------S
#D-------------S
#####---H##ooooS
######MMMMMSSSSS
