##--------------
#####-----------
----------------
---ooo#---------
----------------
------TTTo------
----------------
---------ooo#---
----------------
ooTT--------####
----------------
---####---------
----------------
------TToo------
