####ooo#########
####------------
####------------
####----#-------
--------#-------
--------#-------
--------#-T-----
----------------
----------------
MMMMoooooooSSSSS
----------------
----------------
####----------SS
####----------SS
