----------------
--------oooT----
----------------
--------------T-
----------------
----------------
-----#---#---o--
--o--#---#---#--
--#--#---#---#--
--#--#---#---#--
--#-T-----------
----------------
----------------
----TTTTo-------
