oooo----------##
SSSX------######
----------------
----------------
MMMoooooooooSSSS
----------------
-#--------------
oo----------oooo
XX--------------
#H--------------
MMMSSSoo########
----------##----
----------##----
--#ooo----------
