----------------
---------oooo---
----------------
----------------
##TTTTToo----ooo
#------------SSS
#------------ooo
#--H---------SSS
----------------
----------------
-o--------------
----------------
----o---D#------
--------D#------
