----oooo--------
----------TTo---
---------D------
---------D------
--------XTTT----
----------------
--Tooooooo------
----------------
----------------
TTTo------------
----------------
----------------
------ooo-------
---------ooooooo
