--S--------H----
ooSo??SSSSMMMMMM
----------------
----------------
SSSMMMoooo######
----------------
----H--------#--
oooMMMoooo######
----------------
----------------
-----TT---------
----------------
---H-----H------
oooMMMMMMM######
