----------------
---------ooo----
----------------
S-----------TTT#
S--------------#
S--------------#
Soooooooo------#
SS-------------o
D#--------XXXXXX
D#-------------#
##-------------#
##oooo######---#
--SSSS####-----#
---------#TTTTTT
