-------------###
####ooooo----###
#-----SSSo-o####
#------------###
#-------------D#
#-------------D#
#-------------SS
#-------------SS
#-----ooooooooSS
--------oooooooo
----ooooXXXX----
ooX-------------
----------------
----------------
