###o--------####
###X--oooooo####
###o--------####
###X--------####
######------####
####--------####
####--------D###
---###o--oo#----
---####---o###--
-oo####---X###--
---#####--####--
----####--####--
----####--####--
----####-TT#####
