----------------
--#--------#----
###oooo#####oooo
----------------
----------------
####----oooo####
####--------####
####--------####
######ooo---####
####--------####
####--------####
####-----ooo####
####--------####
####--------####
