---------#------
-----o---#---o--
ooooXXXXoo######
----------------
----------------
---#------------
---#------------
-T-#---o--------
####oooooooooooo
----------------
----------------
---------ooo----
----------------
T-----------XXXX
