----------------
---------###oooo
----------------
------oooT------
----------------
---oooo---------
--------------#-
XXXX--------####
----------------
--------###oo---
--------#-------
------T###------
----------------
---####---------
