####----------##
####------######
----------------
----------------
MMM#############
----------------
-#--------------
##----------####
##--------------
#H--------------
MMM#############
----------##----
----------##----
--####----------
