##--------------
#####-----------
----------------
---####---------
----------------
------TTTT------
----------------
---------####---
----------------
##TT--------####
----------------
---####---------
----------------
------TTT#------
