----------------
--------###T----
----------------
--------------T-
----------------
----------------
-----#---#---#--
--#--#---#---#--
--#--#---#---#--
--#--#---#---#--
--#-T-----------
----------------
----------------
----TTTTT-------
