############----
################
####----------##
####----------##
#-------------##
#-------------##
#-----#####H####
#-----#####MMM##
####-----####---
####-----####---
####--------####
####-#------####
D-----------####
D-----------####
