----------------
----------------
TT####TT########
----------------
----------------
################
----------------
----------------
###########MMM##
#-------------##
#-------------##
###########MMM##
##--------------
##--------------
