##-----------###
##------------##
#########-----##
##------------##
----------------
---------####---
----------------
----------------
##------########
##------------##
##------------##
####----------##
####-----------#
####-----------#
