#---T--TTTTSSSSS
#--------------S
#--------------S
####TTTTT------S
####------------
#--------#------
----------------
----------------
----######TT----
-----------#----
-----------#----
##----------####
##--------------
##--------------
