############----
################
####----------##
####----------##
#-------------##
#-------------##
#-----##########
#-----##########
####-----####---
####-----####---
####--------####
####-#------####
#-----------####
#-----------####
