----------------
##------TTT#####
##------------##
##------------##
####----------##
####-----------#
####-----------#
############---#
###########----#
####----------##
#D-------------#
#D-------------#
#####---XXX#####
######XXXXX#####
