##--------------
#####-----------
----------------
---####---------
----------------
------###T------
----------------
---------####---
----------------
####--------####
----------------
---####---------
----------------
------####------
