####--------####
####--------####
#######-----####
####------#-####
##----------####
##----------####
##----T#########
##--------------
##--------------
###TTT----------
##--------------
----------------
-----TTTT-------
----------------
