----------------
----------------
------XXXX------
----------------
---###X---------
----------------
----------------
####------######
#---------------
#---------------
#------####-----
#---------------
##--------------
##--####--------
