----------------
---####---------
----------------
----------------
##-----##TT---##
##------------##
##------------##
######----######
##------------##
##------------##
#-----####-----#
---------####---
----------------
----------------
