-------------###
#########----###
#-----####-#####
#------------###
#-------------##
#-------------##
#-------------##
#-------------##
#-----##########
--------########
----########----
###-------------
----------------
----------------
----####--------
----------###---
---------#------
---------#------
--------####----
----------------
--########------
----------------
----------------
####------------
----------------
----------------
------###-------
---------#######
----------------
------####------
----------------
---####---------
--------------#-
####--------####
----------------
---------####---
----------------
------####------
----------------
---####---------
----------------
----------------
#######---------
----------------
------####------
----------------
---------####---
----------------
####--------####
-----#----------
----###---------
----------------
------####------
----------------
---------####---
----------------
----------------
---------#######
----------------
------####------
----------------
---####---------
--------------#-
####--------####
----------------
--------#####---
--------#-------
------####------
----------------
---####---------
----------------
----------------
#######---------
----------------
------####------
----------------
---------####---
----------------
####--------####
-----#----------
----###---------
----------------
------####------
----------------
---------####---
----------------
----------------
################
----------------
----#--------#--
################
----------------
----------------
-----##---------
----------------
---#-----#------
################
----------------
--#--------#----
################
----------------
----------------
################
----------------
----#--------#--
################
----------------
----------------
-----##---------
----------------
---#-----#------
################
----------------
--#--------#----
################
----------------
----------------
####----########
####--------####
####--------####
#########---####
####--------####
####--------####
####-----#######
####--------####
####--------####
####--##########
####--------####
####--------####
######------####
####--------####
####--------####
####----########
####--------####
####--------####
#########---####
####--------####
####--------####
####-----#######
####--------####
####--------####
####--##########
####--------####
####--------####
######------####
####--------####
####--------####
---####--###----
---####---####--
-######---####--
---#####--####--
----####--####--
----####--####--
----####-#######
----####--####--
----####--####--
----#####-####--
----------####--
----------####--
---------#####--
-------#--------
################
--------------#-
------------####
--------------#-
----------------
---------#------
---------#------
-----#---#---#--
################
----------------
----------------
---#------------
---#------------
-#-#---#--------
################
----------------
--------------#-
------------####
--------------#-
----------------
---------#------
---------#------
-----#---#---#--
################
----------------
----------------
---#------------
---#------------
-#-#---#--------
################
----------------
----------------
---------###----
----------------
#-----------####
#--------------#
#--------------#
#########------#
##-------------#
##--------######
##-------------#
##-------------#
############---#
--########-----#
---------#######
