--------########
------------####
--###--------###
-------------###
--------------##
--------------##
---------#######
------------####
------########--
----------------
---####--###----
---####---####--
-######---####--
---#####--####--
----####--####--
----####--####--
----####-#######
----####--####--
----####--####--
----#####-####--
----------####--
----------####--
---------#####--
-------#--------
----------------
---####--###----
---####---####--
-######---####--
---#####--####--
----####--####--
----####--####--
----####-#######
----####--####--
----####--####--
----#####-####--
----------####--
----------####--
---------#####--
-------#--------
################
----------------
----------------
########--------
---------####---
----------------
####--------####
----------------
----------------
-----####-------
----------------
####--------####
------------####
-----------#####
-------#########
------##########
----##----------
----##----------
----##----------
######-------###
------------##--
------####--##--
------------##--
------------##--
----------####--
----------------
---#---#--------
################
----------------
----------------
-------##-------
---------#------
----------------
-----#----------
-----------#----
----------------
----------------
-------------#--
----------------
----------------
-------#---#----
----------------
----#-----------
----------------
----------------
---#------------
---------#------
----------------
-----#----------
-----------#----
----------------
----------------
-------------#--
----------------
----------------
-------#---#----
----------------
----#-----------
----------------
----------------
---#------------
----------------
----------------
----####--------
----------###---
----------------
----------------
--------####----
----------------
--########------
----------------
----------------
####------------
----------------
----------------
------###-------
----------------
----------------
----####--------
----------###---
----------------
----------------
--------####----
----------------
--########------
----------------
----------------
####------------
----------------
----------------
------###-------
----------------
----------------
----####--------
----------###---
----------------
----------------
--------####----
----------------
--########------
----------------
----------------
####------------
----------------
----------------
------###-------
----------------
---------###----
----------------
#-----------####
#--------------#
#--------------#
#########------#
##-------------#
##--------######
##-------------#
##-------------#
############--##
--########----##
---------#######
