####------------
########--------
#---########----
#-------########
#-----------####
#-------------##
#-------------##
#---####------##
#---########--##
##------########
##----------####
##-----------###
##########---###
####-----------#
####-----------#
---------####--#
##-------##---##
##----#####---#-
##------------#-
#####---------#-
--------------##
---####-------##
-----##-------##
-----#####----##
----------------
----------------
---------####---
----------------
########----####
------------####
------------####
------##########
------##--------
------##--------
########----####
----------------
---------####---
----------------
------####------
------##--------
---#####--------
---##-----------
#####---------##
#-------------##
#-------------##
####-------#####
################
#--------------#
#--------------#
#---####-------#
#--------------#
----------------
################
#--------------#
##-----------###
################
----------------
----------------
################
#--------------#
#----#---------#
#--------------#
----------------
---#------------
----------------
#########--#####
-########--#####
---------#-----#
---------------#
----------------
----------#-----
----------------
----------------
##----------####
##----------####
#########---####
####------######
####------####--
#####-########--
####------####--
##-----------###
##--##-------###
##-----------###
##-----------###
-########--####-
-####------####-
-####------####-
-####----######-
##----------####
##----------####
#########---####
####------######
####------####--
#####-########--
####------####--
##-----------###
##--##-------###
##-----------###
##-----------###
-########--####-
-####------####-
-####------####-
-####----######-
##----------####
##----------####
#########---####
####------######
####------####--
#####-########--
####------####--
##-----------###
##--##-------###
##-----------###
##-----------###
-########--####-
-####------####-
-####------####-
-####----######-
----------------
----------------
-------########-
-####-----------
----------------
----------------
----####--------
----------------
####----------##
--------------##
--------------##
-----------#####
----#####-------
----------------
####----------##
-------------###
-------------###
-----------#-###
-------#########
-----#-######-#-
----------------
----------------
####------------
####------------
########--------
######-##-------
----------------
----------------
--------####----
----------------
#-------------##
#-------------##
####-------#####
################
#--------------#
#--------------#
#---####-------#
#--------------#
----------------
################
#--------------#
##-----------###
################
----------------
----------------
#----##-------##
###--##----#####
#---###-------##
#----##-------##
#--##--######--#
#------####----#
##-----####--#-#
###----####----#
##----##-------#
####--##-----#-#
------##-------#
-----###-------#
-------#----##--
---##--#--------
-------#--------
#----##-------##
###--##----#####
#---####------##
#----###------##
#--##--######--#
#------####----#
##-----####--#-#
###----####----#
##----##-------#
####--##-----#-#
------##-------#
-----###-------#
-------#----##--
---##--#--------
-------#--------
------------#---
----##---##-----
----------------
----------------
-----#######----
----------------
----------------
---####--####---
----------------
----------------
------####------
----------------
----------####--
----------------
----------------
---------#######
----------------
-------####-----
---####---------
---####---------
---#------------
####---------###
----------------
-----------####-
-------####-----
-------####-----
----####--------
########-------#
---------------#
---------------#
-------------###
-------------###
-----------#-###
-------#########
-----#-######-#-
----------------
----------------
####------------
####------------
########--------
######-##-------
----------------
----------------
--------####----
----------------
----------------
-----#----------
----------------
----------------
----####--------
----------------
--------####----
#-------------##
#-------------##
#-------------##
#-----##########
#--####---------
#---------------
#---------------
#####-----------
--##------------
--#####---------
-----##---------
-----#####------
--------##------
--------#####---
-----------##---
####-------#####
--##-----------#
--#####--------#
-----##--------#
-----#####-----#
---------##----#
---------##----#
---------------#
#-----------####
#---############
#-------------##
#-------------##
####----------##
########------##
############--##
##------------##
##-----------###
##-----------###
##-----------###
################
################
