########-----###
#----#####--####
#--######--####-
#-########----##
#-------------##
#-------------##
#-------------##
#-#---------####
#-#-----####----
########--######
----------------
---------------#
-########----###
------------####
----------------
--------###-----
----------------
----------------
###---------####
----------------
------------####
####------------
----------------
--########------
----------------
----------------
------------####
####------------
----------######
-------####-----
-------####-----
---------------#
-####--------###
##----------####
----------------
------####------
########--------
----------------
------------####
----------------
--------########
----------------
----------------
########--------
---------####---
----------------
####--------####
----------------
----------------
-----####-------
----------------
####--------####
------------####
-----------#####
-------#########
------##########
----------------
----------------
----####--------
----------###---
----------------
----------------
--------####----
----------------
--########------
----------------
----------------
####------------
----------------
----------------
------###-------
---####--###----
---####---####--
-######---####--
---#####--####--
----####--####--
----####--####--
----####-#######
----####--####--
----####--####--
----#####-####--
----------####--
----------####--
---------#####--
-------#--------
----------------
---------#######
----------------
------####------
----------------
---####---------
--------------#-
####--------####
----------------
---------####---
----------------
------####------
----------------
---####---------
----------------
----------------
#######---------
----------------
------####------
----------------
---------####---
----------------
####--------####
-----#----------
----###---------
----------------
------####------
----------------
---------####---
----------------
----------------
################
----------------
----------------
-####-----------
----------------
----------------
-------##-------
----------------
----------------
-----------####-
----------------
----------------
-########-------
----------------
----------------
################
----------------
----------------
-####-----------
----------------
----------------
-------##-------
----------------
----------------
-----------####-
----------------
----------------
-########-------
----------------
----------------
####--------####
####--------####
#######-----####
####--------####
##------------##
##-----####---##
##------------##
####--------####
######------####
####--------####
####--------####
##----##########
##------------##
##------------##
#####---#-----##
####--------####
####--------####
#######-----####
####--------####
##------------##
##-----####---##
##------------##
####--------####
######------####
####--------####
####--------####
##----##########
##------------##
##------------##
#####---#-----##
################
----------------
----#--------#--
################
----------------
----------------
-----##---------
----------------
---#-----#------
################
----------------
--#--------#----
################
----------------
----------------
################
----------------
----#--------#--
################
----------------
----------------
-----##---------
----------------
---#-----#------
################
----------------
--#--------#----
################
----------------
----------------
---------#------
----------------
-----#----------
-----------#----
----------------
----------------
-------------#--
----------------
----------------
-------#---#----
----------------
----#-----------
----------------
----------------
---#------------
-####-----------
----------------
----------------
####------------
####------------
####--####------
####------------
##-------------#
##----------####
##-------------#
##-------------#
###########-----
