-----------#----
--------#-------
----------------
--------#-------
---######-------
----------------
----------------
----------------
----------------
----------------
--------#---#--#
--------------#-
----------------
##----#-#-------
#----------#----
#-#------#------
