------##-####---
----------#-----
----------------
----------------
---#-#----------
---###-----#----
---#-####-------
----------------
----###---------
----------------
-------------#--
--#-----#--###--
------------#---
-----------#####
-------###------
----------------
