----------------
------###----#--
----------####--
----------####--
----------####--
----------------
----------------
-------#--------
----------------
----------------
---------#------
----------------
-----#----------
---#------------
----------------
----------------
