----------------
####------------
-------------#--
----------------
-----#----------
----------------
--------#-------
--------###-----
----------------
---####---------
----------------
---####---------
---#------------
####-----#------
----------------
--#-------###-#-
