----------------
-----##-##-#---#
---#--------####
--------------##
--------------##
----------------
----------------
--------####-#-#
#--------------#
#--#####-------#
#------#-------#
--##-----------#
----------------
---------------#
#-##----------##
--##----------##
