-----##--#-----#
--------##------
----------#----#
----------###-##
------------###-
----------------
----------------
-------#-##-----
------##--------
----####-#------
----------------
----------------
---#------------
---------#------
----------------
------##-#######
