#-----#-###-####
---###-#--------
---#------------
#-####-#--------
---#-----------#
----------------
---#--###-------
-------#------##
---##-##--------
---------------#
--------------##
#-------#-----##
#---------------
#--#-----------#
#--#-----#---#-#
----------------
