----------------
--#####---------
---------#------
---------#------
----------------
------##--------
------#---------
---#####-----#--
----------------
#------------#--
--------#----#--
----#-----------
----------------
--------------#-
----------------
---------#------
