-----------#-#--
---------#-#----
----------#-----
-#--------------
----------------
-------###------
-----#----------
---------#--#---
--#---------#---
--#----------###
---#---------#--
--#######-------
--------#-------
----------------
----------------
--------#-------
