---------#--####
------------###-
-----###--####--
-----#----#####-
----##----------
----##----------
-----------#----
------#---------
----#--#--------
---#####----##--
----------------
----------------
---------#####--
----------------
----------------
---------#----#-
