--###-----------
--##-#----------
--#--#----------
-----#--#-------
--------#-------
----------------
----------------
----------------
#--#----------#-
#-##----------##
#--#-------#---#
#------####----#
#------##------#
#-----######---#
#------#-------#
##-#####-----#-#
