##----------####
#-------##--####
#------#----####
---##-#---------
--#-##----------
###----------##-
##--------------
----------------
----------------
----------------
----------------
----------------
--------##------
----------------
----------------
-------------##-
