-------#------##
----###--#----##
--------------##
--------##------
----------------
--------####----
----------------
------------####
##------------##
--------------##
---#####------##
---------------#
----------#-#---
----------------
----------------
--------------##
