------------###-
----##------####
------------####
----#----#-###--
------------#-#-
------------#---
------------#---
-###-#-----#####
------------##--
-------------#--
------------##--
----------------
--###-------##--
------------##--
----------------
--------##--###-
