---#-##----#----
----------------
----#-----------
--------####----
--------#-#-----
-------##-------
---------#------
----#-----------
----------------
----------------
#-----#---------
----------------
-----------#-###
----------------
----------------
----###--#------
