#--#-----#------
#--#------------
###------------#
#----##---------
#---------------
#--#--#---------
----------------
---#-----###--##
--------------##
---#-------#--##
--##-----------#
--#####--------#
---------------#
---------------#
-#-##--#-##--#-#
###-----###--#-#
