##-#--------###-
##-#-------##---
-------#--------
----------------
-----#-------#--
----####--------
----------------
----#----#------
----------------
---##----#######
----------------
----------------
-----------#----
---####---------
----------------
------##-#--##--
