----------------
---#------------
----------------
--####-###------
---###----------
----------------
------#-####---#
----------------
----------------
----------------
--------##------
----------------
----###---------
##--########--##
--##------------
####---##--#---#
