#---------##-###
#---#####------#
#---#--#-##--#--
#---------------
######----------
#-----------#---
##-#---------#-#
--------------##
------------####
-------------###
-#--------------
--------------#-
----------------
##-------#------
#---------------
#-----####------
