######-####-#--#
#--------------#
##-------#-----#
-#-----#-###-#-#
---------------#
##-------------#
##-#-----------#
#---####-------#
##-----------#-#
----------#----#
---------------#
---------------#
-------------#-#
------##--------
-----------#---#
---###---####-##
