##------------##
##--------------
----------------
---#------------
--------##------
-----------#----
#------------###
---#------------
----#-----------
------#---------
----------------
----------##----
----------------
----------------
----------------
-----#----------
