--#------##--#-#
------####-----#
#-#---###------#
####---#-------#
---------------#
#--#--#--#-----#
---------------#
------##-------#
------##-----#-#
---#------------
------#---------
-----###--------
##-#-#--------##
#---####------##
#-----#-------##
#-###--#--######
