----####--------
----##-#--##---#
----------#--##-
-#-##----------#
---##--##----##-
----------------
----------------
---------####---
---------------#
----------------
------##---#----
----------------
--###-----------
---------####--#
--------------##
---#--##--------
