--------#-------
--------------##
######------####
---------#-----#
---------------#
------########--
----------##----
#-##------##-#--
--##-#----#-###-
-------------###
-------------###
-------------###
---------#--###-
----------------
------###----#--
----------------
