---#-----##-----
#--#------------
#-------------##
#########--#-###
-----------###--
---##------#----
---#-------#----
----------------
---#------------
####------------
--#####-####----
---#-#----------
----------------
---------###----
---------------#
####---#########
