--########------
----------------
####----------##
--#--------#---#
---------------#
----------------
-----###--------
-------#--------
---#------------
---------###----
----------------
##---#-------###
#--#--#--------#
----------------
--#--------#----
----------------
