--------------#-
----------------
##---#----------
-----#----------
----###-##------
---------#------
---------#-##---
----------------
----------------
-----#----------
----------------
--------#####---
----------------
-------#-----#--
--##--#-----#-#-
-----##-----##--
