####----------#-
--##---#########
-------------##-
---####---------
----------------
----------------
----------------
----------------
#--------#--##-#
#--------------#
##--------------
##---------#####
---------------#
-----#-#-------#
-##-------------
--------------#-
