####---#--------
----------------
----------------
--------##------
---#----###-----
----------------
---#-#----------
######----------
--#------------#
------------#---
--------#-------
--------##------
------####---#--
----####--------
----------------
----------------
