##--------------
######----------
#-------#-------
----------------
####----#-----#-
----------------
----------------
-----##-#-#-----
----------------
------------###-
----------------
--##--------####
--####--------##
--##-#---------#
----------------
-------##-------
