--------------#-
#---------------
----------------
----------------
-#--#-----------
----#-----------
-----###--------
#######------###
----------------
---------#------
---------#------
----------------
------------#---
--##-----------#
----------------
-------------#--
