--------#------#
--#----###------
--##------------
---#-###--------
-###---#--------
#####--#------##
#####--##-----##
##--------#-#--#
---------------#
----------------
----------------
----------------
-------##-------
-----#----------
-----#----------
-#####----------
