####----------##
#--#-----------#
---------------#
###---#-####--##
----------------
-------------#--
#########--#----
----------------
----------------
------#---------
------#--#------
------#---------
-----###--------
-----------#----
#--#-----------#
----------------
