#--------#-#----
----------------
---------------#
--####---------#
--#------------#
##########--#--#
--##-------#----
---#------------
----------------
------------####
-----------###--
-----------#----
---#--#---######
-----###--###---
------#---##----
#---#####-####--
