------#--##---##
------#---#-----
----#-----#-##--
----####-----#--
------#-----#---
------#---#-##--
------#--##-----
------#-##-#----
------####------
---#--#-#-------
---#------###---
---#------#-----
##-#--------##--
--##------------
--###-----------
------#---------
