------------#---
-----------###--
----------------
--####---#####-#
--##-#----------
-##-##---------#
---###-##--#---#
-----#---------#
----##---------#
----------------
---------------#
-------#-#--#---
-----------##---
-------------#--
--------###-----
----------------
