##-###----------
-------#--------
---#-#----#-#-##
---------------#
--------##------
----------------
------#--#######
----------------
----------------
--####-------###
----#-----------
--------###-----
----#####-------
----####----##--
----#------#----
----####-------#
