----------------
----------------
#---------------
#---------------
##-#------#----#
-----------#---#
----#-----------
#---------------
##--##----------
##-----------###
##-----------#--
####---------###
####-----######-
##--------------
-#-----##----##-
----------------
