#-----------#-##
##-#--#--#--####
#--#--------####
#-------#---####
--#----------#-#
##----####------
#----######-#--#
-#----####-----#
#####-----#-##-#
---------------#
---------------#
---------#--###-
------##--------
----------------
---####---------
-##-##----------
