#-----#-------##
#--#-###--------
----------------
#-##------#-----
##-------------#
###---------####
#--#-##--------#
#----###-------#
---#------------
#--------------#
---------##----#
---------------#
------#####-####
-----#----------
----------------
####--##------##
