----------#-----
---------------#
----------------
----------------
#--#-----------#
#--#------#---##
#---------------
#--#------------
#--##---#--#----
#---------------
----------------
----------------
----------------
----------------
--------------##
#--------------#
