-------###-#---#
----------------
#-###-----------
----------------
---#-#-#--------
####---##-------
-------###------
----------------
------#---------
----------------
----------------
------------##--
----------------
-----#----------
----------------
----------------
