----------------
##---------#####
---------------#
#---####--------
#--------#######
----------------
----------------
---------####---
----------------
-------##-------
-#---------###-#
----------------
------##-----#--
----------------
---#------------
-----------#----
