##-#---------#--
----------------
----------------
-------------#--
--------------#-
-------#--------
----------------
-----#---##-----
----------------
----------------
----------###---
----------------
--###-#---------
----------------
----------------
-----------#----
