----------------
------------##--
---------#------
#---------------
-------#--#-----
#---#-####------
----------#-----
###-------------
#--#------------
####------------
####------------
--######--------
---#------------
-###------------
-###------------
--------------#-
