---#-----##-----
---------------#
##-#--------####
#-------------##
#---------------
#---------------
----------------
#---------##----
##--------------
#--------------#
##--------------
-#--------------
---------------#
----------------
---#------------
---#----####----
