-#####----####--
----------------
----------------
------------#---
----------------
---------#------
-------#-###----
----##----------
----#-----------
----------------
----------------
----------------
---------#------
----------------
-----#----------
-----#----###---
