----------------
----------------
----------------
----------------
----------------
------#---------
##------#####---
--------------#-
------------#---
#---------------
-------------#-#
##--------------
##-----------#-#
-------------#--
-------------#--
-------------#--
