--#-#-----------
---#--------####
----------------
----------------
----------------
---#------------
----#-----------
----------------
##---------#----
##--------####--
####---#----####
-#-------------#
-#######--------
#####----------#
---------------#
#--------#--####
