-------#--------
----------##----
----------------
########--------
######-##--#-#-#
-#-----#--------
----------------
---------###----
----------------
-------##-----#-
--------########
--------##----#-
#---------------
#--------------#
#-##---#-------#
#--------------#
