##-#-----------#
---------------#
-------#-------#
---------------#
---------------#
----------------
----------------
-----#------##--
---------------#
----------------
----------------
---#------------
-------------#--
----------------
-------##-#-----
---------##-----
