---#------#---#-
----------#-----
----------------
-#-------------#
-----#----------
-----#----------
----------------
---#---#-##-----
---#------------
-#------------##
##----------####
##----------####
#------------###
------########-#
-#-#-------#----
------##--####--
