#--------#---#-#
#--------------#
###------------#
----------------
---------------#
------------###-
----------------
----------------
-------------#--
---------#------
----------------
----------------
-#####-#--------
-----------##--#
----------------
-------#--###---
