---------##-----
---------#####-#
---###--##--####
--#--#-------###
----#-----------
----------------
---###---------#
---------##----#
---------##--#--
------##-#-#-#--
---------##-###-
------#---------
----------------
------#---------
---#-#----------
----------------
