#-----#--------#
--------###-#---
----------------
-------#------#-
-#----------##-#
#---#-----------
----------------
----------------
---#####--------
----------------
-------####-----
---------#------
---------###----
----------------
---#------------
-------------#--
