---------#####--
----------------
----------------
#-######--##----
##-#------------
----------------
------#--###----
----------------
------##--------
-------#-----#--
-----#----------
---####---#-#---
----------#-##--
----------####--
----------####--
-------###-#----
