---------####---
----------###---
------------#--#
####--------####
---#-#------####
----------#--###
---#--######---#
---#-----##-----
----------------
#---#-----------
####---------###
#------------###
---#-----#--#-##
---#--####--#-##
---#----------##
--##----------##
