----####---###--
----####-#--##--
----------#-----
------#---------
----------------
------####------
------#---------
-----##-#####---
----------------
#--####---------
-------#--------
-------#--------
#####-----------
-----##-##--####
----------------
---#--##--------
