##-----#-#######
----------------
--------------#-
##--------------
----------------
##-----##--###--
-#--------------
----------------
----------------
----------------
---------###----
----------------
-----#----------
------------####
----------------
----#######-#---
