#---------------
##--###---------
#---------------
---------------#
--##----------##
------#-------##
------#-------##
-------#########
----------------
----------------
-------###--##--
###---#---------
--------------##
-----##-------##
------#-#----#-#
--------------##
