#--------#####--
----------------
----------------
-----------#####
-#-----------#--
-#####------####
------------####
--###-#-----####
----------#-###-
----------------
----------------
------------#---
----##--##------
----------------
----------------
---##--#-##--#--
