--#-#----#####--
----------###---
-----------#----
--####-------#--
----------------
----------------
-----#####--##--
----------------
----------------
-##----##--###--
------------##--
------------##--
--##----######--
-----------##---
##-----------#-#
-###--###-##----
