####-#----#-####
------------####
------------####
----#####---##--
-#-----------#--
-##-------------
-#---#----------
------------##--
----------------
------###-------
-----------##---
---------#------
--------#-------
----------##----
---#----------#-
------####----#-
