--#####-----##--
-----#-------#--
--#----##----#--
-----------#----
----------------
--------#-#-----
----------------
----------------
----------------
-##--#----------
----------------
----------------
----------------
----------------
--------#-------
------------#--#
