######----------
####------------
####-#----------
----------------
----------------
----------------
-----#----------
----------------
-#-------------#
----------------
----------------
#-------##------
##-------#------
####----##---###
##-#----------##
---######-----##
