##------------##
--------------##
------------#-##
------#-##-----#
----------------
---------##-----
#--------------#
##-----------#--
###-----------##
#---###--------#
----------###---
---------#------
------#####----#
----------------
----------------
#######--------#
