#------###-----#
#---------------
----------------
#--#------------
##-#----------##
##-------------#
########------##
#--#------------
#---------------
-#--------------
----------------
---#---#------#-
--########----#-
####--------####
#-#------------#
####-------###-#
