-----######-----
---------##-----
----------#-----
----------#-####
--------------##
---------------#
-----------#####
-------#--------
--#---##--------
----------##----
---------------#
--###--------#--
----------------
----------------
----------------
----------------
