##-----#-##-####
##--------------
--------------#-
-----------#--#-
---#------------
----------------
----------------
-#--------------
---#------------
--------#-------
----------------
-------##-------
#---------------
##------------##
#-#######-----##
--------------#-
