------###----###
---------------#
----------##-#--
----------------
----------------
-#-----#--------
----------------
----------------
----------------
----------------
----------------
---------#------
-----#---------#
-----#----------
----------------
---------------#
