#--#----------##
##-#----------##
---#-#-----#---#
-#----------#-##
----------------
---------##-----
----------------
--##------------
---####---------
---####--------#
---------------#
----####-------#
-------------###
-------------###
---------##----#
----------------
