----------####--
----------------
----------------
-#----------##-#
----------------
#---####--------
--------------##
----------------
---------#------
---------------#
#--------------#
##---#-##-----##
##----#-------##
##-----------###
###-------#---##
####------######
