-####-#--#####--
------------##--
-------#-----#-#
-----#-#--------
-----##---------
----------------
----------------
---#--------#---
----------------
---#------------
----------####--
-#------###-##--
------------#---
----------------
----#-----------
---###----------
