#--#-----#------
#---------------
----------------
##--###---------
##--------------
#---------------
###-##----------
##-###----------
#---------------
----#-######---#
----------------
----------------
-------------#--
----------------
----------------
--#-----------#-
