----------------
---------####-##
------------#-##
----------------
---------####---
----------------
----------------
#---#-###-----##
----------------
--------##------
---------------#
----------------
##-#----------##
-------#--------
---------####---
-------------###
