##-#-###----#---
----------------
----------------
----------------
-------#--------
------##--------
---##-##--------
----------------
----------------
#####-----------
----------------
----------------
-----##---------
---------#------
----------------
-#-##-##-#-##--#
