#---------------
---------------#
####-####-----##
--------------##
##-#----------##
---------------#
------#----#####
#------------#--
#-----------##--
#---####----####
##-----------###
-------------###
---------#--##--
---------####---
------##-#####--
------##---##---
