#---------####--
------#---------
----------------
-------------#--
----------------
----------------
----------------
----------------
----------------
-----------#----
----------------
--------#-------
----------------
----------------
----------------
-----------#####
