----------------
----------------
----oooo--------
----------ooo---
----------------
----------------
--------oooo----
----------------
--MMMMMooo------
----------------
----------------
oo##------------
----------------
----------------
