------TTT-------
---D###--Too----
---D###---####--
-TTT###---####--
---#####--####--
----####--####--
----####--####--
----####-o######
----####--####--
----####--####--
----##TTT-####--
----------####--
----------####--
---------TTT##--
