----------TTTTTT
-------####-----
-------TTTT-----
---------------#
-oooo--------###
XX----------oooo
----------------
------oooo------
ooooooSS--------
----------------
------------####
----------------
--------ooooTTTT
----------------
