---SSSo---------
----------------
----------------
ooooooo---------
----------------
------TTTT------
----------------
---------TToo---
----------------
oooX--------####
-----o----------
----XXT---------
----------------
------TToo------
