####--------####
####oo------####
####--------####
####--------oooo
##----ooooooSSSS
##------------##
##------------##
##HHH---H-----##
####MMMMMooo####
----------------
----#--------H--
oooo#####ooMMMMM
----------------
----------------
