----------------
-----oo---------
----------------
---H-----D------
ooMMMMMTTTTMMMMM
----------------
--H--------#----
oooooooooooooooo
----------------
----------------
---------o------
----------------
-----o----------
-----------o----
