----------------
---#------------
-TT#o-----------
----------------
----------------
####------------
####------------
####--oooo------
####------------
##-------------#
##----------TTTT
##-------------#
##-------------#
####ooooooo-----
