-----------oooo-
----------------
----------------
-oooooooo-------
----------------
----------------
####--------####
####--------####
######o-----D###
###T--------####
##------------##
#D-----ooo#---D#
#D------------D#
####--------####
