-----oo---------
----------------
---o-----o------
XXXoooooooooSSSS
----------------
--o--------#----
ooooooooo###oooo
----------------
----------------
SSSMMMSSSSSSoooo
----------------
----H--------o--
oooMMMooooooXXXX
----------------
