##MMM###-----###
#----###oo--####
#--H####o--####-
#-MMM###XX----##
#-------------##
#-------------D#
#-------------D#
>-[---------####
]-[-----####----
XXXooooo--##TTTT
----------------
---------------#
-oooooooo----###
------------####
