----------------
--------ooo-----
----------------
----------------
ooo---------oooo
----------------
------------oooo
oo##------------
----------------
--TTTTTooo------
----------------
----------------
------------oooo
XXoo------------
