---###XX--XXXX--
----##XS--XXXX--
----##XX--XXXX--
----##XX-SXXXXXX
----XXXX--XXXX--
----XXXX--XXXX--
----XXXXX-XXXX--
----------XXXX--
----------####--
---------TTT##--
-------H--------
XXXXXXMMMMMMMMMM
----------------
----------------
