----------------
---------XXX----
----------------
X-----------XXXX
X--------------X
X--------------X
XXXXXXXXX------X
XX-------------X
XX--------XXXXXX
#D-------------#
#D-------------#
TTTT#Eooo###--D#
--TTTXXXXT----D#
---------TTTTTTT
