----------------
XXXX------------
----------------
----------------
------XXX-------
----------------
---------XXX----
----------------
X-----------TTTT
X--------------#
X--------------#
XXXXXXXXX------#
XX-------------#
XX--------TTTTTT
