TTXX------------
----------------
----------------
------XXX-------
----------------
----------------
----XXXX--------
----------XXX---
----------------
----------------
--------TTXX----
----------------
--XXXXXX##------
----------------
