XXXXXXXX--------
---------XXXX---
----------------
XXXX--------XXXX
----------------
----------------
-----XXXX-------
----------------
XXXX--------Eooo
------------XXXX
-----------SSSSS
-------EoooSSSSS
------#XXXXSSSSS
----XH----------
