----XXXX--####--
----XXXX--####--
----XXXX-T######
----XXXX--####--
----Eooo--#XXX--
----XXXXT-#XXX--
----------#XXX--
----------#ooo--
---------T#XXX--
-------H--------
----------------
---XX##--TTX----
---XX##---#XXX--
-XXXX##---#XXX--
