--------XXX#####
------------####
--XXX--------###
-------------###
--------------D#
--------------D#
---------XX#####
------------TTTT
------XXXTTTTT--
----------------
---D###--TTT----
---D##D---####--
-TTT##D---####--
---#####--####--
