##-#-----------X
#--DMMMM-------X
D--D-----------X
D-##-----XX##--#
#--X-----------#
#--X----------##
##-X----------##
E--<----------[]
>--[---ETTTXXXXX
--##---[X-------
---#---[X-------
---#-SS[X-------
####---[X-----XX
####---[X---XXXX
