----------------
-----XX--XX-----
----------------
----------------
--##------------
--####D---------
-----#D---------
-----ooTTT------
--------##------
--------TT###---
-----------##---
####-------#####
--##-----------#
--#####--------#
