SS##TT-XX-----SS
SS##---XX-----SS
------T---XX----
----------------
----------------
-----TTXXX------
----------------
----------------
---TTTT--MMTT---
----------------
----------------
-------SS--SSSS-
----------------
----------------
