###XX###-------#
#TTX---#TTT----#
---------------#
-----------TH--#
---------------#
---------------#
-------------H##
---------------#
------##########
------SS--------
------SS--------
MMMMMMSS----MMMM
----------------
----------------
