---#------------
###-----------XX
#######XXX----XX
[]------------[]
XX------------[]
##----#MMMMXXXXX
##------------<>
##------------[]
TTTT###X------[]
##----#SXSS---##
#D------------##
#D------------##
#####-------####
#######XXXX#####
