---T####--XXXX--
----####--XXXX--
----####--XXXX--
----####-TXXXXXX
----[]##--XXXX--
----[]##--XXXX--
----[]TTT-XXXX--
----------XXXX--
----------####--
---------TTT##--
-------H--------
SSSSMMMMMMMMMMMM
----------------
----------------
