----####--D###--
----####--D###--
----####-T######
----####--####--
----Eooo--####--
----XXXXT-####--
----------####--
----------#HHH--
---------TT###--
-------H--------
----------------
---XX##--TTT----
---XX##---####--
-SQXX##---####--
