--------XXX#####
------------####
--SSX--------###
-------------###
--------------D#
--------------D#
---------#######
------------TTTT
------SSSTTTTT--
----------------
---D###--TTT----
---D##D---####--
-TTT##D---####--
---#####--####--
