----------------
MMMM------------
----------------
----------------
------###-------
----------------
---------#XX----
----------------
T-----------TTTT
#--------------#
#--------------#
#####SQQS------#
##-------------#
##--------TTTTTT
