----------------
----------------
------XXX-------
----------------
----------------
----XXXX--------
----------XXX---
----------------
----------------
--------##XX----
----------------
--T###TTTT------
----------------
----------------
