S?SQS?SQ--------
---------S?TT---
----------------
S?SQ--------TTTT
----------------
----------------
-----S?SQ-------
----------------
S?SQ--------oooo
------------SSSS
-----------SSSSS
-------ooooSSSSS
------QSSSSSSSSS
----QE----------
