---SSS<>--<>[]--
----SS[]--[][]--
----SS[]--[][]--
----SS[]-EXXXXXX
----<><>--####--
----[][]--####--
----[][]E-####--
----------####--
----------####--
---------TTT##--
-------H--------
S?SQS?MMMMMMMMMM
----------------
----------------
