----#S----------
----#S----------
#####S-------###
------------##--
------QSQS--<>--
------------[]--
------------[]--
----------S?QS--
----------------
---E---D--------
XXXXX###?SQSSSSS
----------------
----------------
-------#E-------
