----------------
----------------
------SSS-------
----------------
----------------
----QSQS--------
----------SQS---
----------------
----------------
--------TTSS----
----------------
--S?SQ####------
----------------
----------------
