----####--####--
----####--####--
----D###-T######
----D###--####--
----SSSS--#SSS--
----SSSST-#SSS--
----------#SSS--
----------#SoS--
---------T#SSS--
-------H--------
----------------
---<>##--TTT----
---[]##---####--
-S?[]##---####--
