----------------
S?SQ------------
----------------
----------------
------SQS-------
----------------
---------QQS----
----------------
Q-----------TTTT
#--------------#
#--------------#
##S?S?SQS------#
##-------------#
##--------TTTTTT
