--------SSS#####
------------####
--S?Q--------###
-------------###
--------------D#
--------------D#
---------S?#####
------------TTTT
------S?STTTTT--
----------------
---D###--TTT----
---D##D---####--
-TTT##D---####--
---#####--####--
