TTS?------------
----------------
----------------
------QQS-------
----------------
----------------
----S?SQ--------
----------SQS---
----------------
----------------
--------ooSS----
----------------
--S?SSSSSS------
----------------
