----------------
---S------------
----------------
----------------
----ES?Q--------
----------TTT---
----------------
----------------
--------S?TT----
----------------
--E?SSSSSQ------
----------------
----------------
XXXo------------
