----------------
---------SQS----
----------------
>-----------S?SQ
]--------------<
E--------------[
SSSSSS?SQ------[
<>-------------[
[]--------S?XXXX
#D-------------#
#D-------------#
TTTT#oooo###--D#
--TTTSSSST----D#
---------TTTTTTT
