----------------
MMMM###T--------
---------S###---
----------------
MMMM--------TTTT
----------------
----------------
-----ooXX-------
----------------
MM##--------####
------------####
-----------#####
-------#HH######
------####TTTTTT
