####--------SSSS
####XX------SSSS
####--------SSSS
####--------####
##----XXX#######
##------------##
##------------##
##HH#---H-----##
#####MMMMooo####
----------------
----H--------H--
SSSSMMMMM##MMMMM
----------------
----------------
