----------------
---------T###---
----------------
----------------
TTMMMMTTTTTSSSSS
----------------
----------------
-TTTT-----------
----------------
----------------
-------TT-------
----------------
----------------
-----------#TT#-
