----------------
--------XSS-----
----------------
----------------
TTT---------TTTT
----------------
------------###H
MM##------------
----------------
--TTTTT###------
----------------
----------------
------------SSS?
MMTT------------
