----------------
---H------------
-###X-----------
----------------
----------------
####------------
####------------
####--<TTT------
####------------
##-------------#
##----------TTTT
##-------------#
##-------------#
TTTTXXXXXXX-----
