----------------
----------------
----XXSS--------
----------TTT---
----------------
----------------
--------##TT----
----------------
--TTTTTXXX------
----------------
----------------
XX##------------
----------------
----------------
