----------------
----------------
-XXXXXXQS-------
----------------
----------------
TTMMMMMH###MMMMM
----------------
----------------
-TTTT-----------
----------------
----------------
-------oo-------
----------------
----------------
