----------------
-----SS---------
----------------
---H-----E------
XXMMMMMXXXXMMMMM
----------------
--H--------H----
MMTTTTXXXXXMMMMM
----------------
----------------
---------S------
----------------
-----T----------
-----------S----
