----------------
---------ooo----
----------------
o-----------oooo
X--------------#
#--------------#
#####oooo------#
oo-------------#
XX--------oo####
#D-------------#
#D-------------#
TTTT#oooo###--D#
--TTTSSSST----D#
---------TTTTTTT
