----####--####--
----####--####--
----D###-T######
----D###--####--
----oooo--####--
----XXXXT-####--
----------####--
----------#ooo--
---------T#XXX--
-------H--------
----------------
---####--TTT----
---####---####--
-oo####---####--
