----------------
oooo------------
----------------
----------------
------ooo-------
----------------
---------ooo----
----------------
o-----------TTTT
#--------------#
#--------------#
##ooooooo------#
##-------------#
##--------TTTTTT
