----##----------
----##----------
######-------###
------------##--
------oooo--##--
------------##--
------------##--
----------oooo--
----------------
---H---D--------
MMMMM###SSSSoooo
----------------
----------------
-------#o-------
