----------------
---T------------
----------------
----------------
----Tooo--------
----------TTT---
----------------
----------------
--------ooTT----
----------------
--#?SSSSoo------
----------------
----------------
###o------------
