----##----------
----##----------
######-------###
------------##--
------E##H--##--
------------##--
------------##--
----------ESEE--
----------------
---E---D--------
XXXXX###SSSSESSS
----------------
----------------
-------#E-------
