----------------
---------ESS----
----------------
E-----------Eooo
>--------------#
E--------------#
XXXXXESSS------#
EX-------------#
XX--------EE####
#D-------------#
#D-------------#
TTTT#Eooo###--D#
--TTTXXXXT----D#
---------TTTTTTT
