----------------
----------------
------EEE-------
----------------
----------------
----EEEE--------
----------TTT---
----------------
----------------
--------TTTT----
----------------
--ESSS####------
----------------
----------------
