----####--####--
----####--####--
----D###-H######
----D###--####--
----Eooo--#E<>--
----XXXXT-#>[]--
----------#][]--
----------#HHH--
---------T####--
-------H--------
----------------
---EX##--TTT----
--->X##---####--
-EE]X##---####--
