TTEE------------
----------------
----------------
------EEE-------
----------------
----------------
----ESSS--------
----------TTT---
----------------
----------------
--------TT##----
----------------
--EEESSS##------
----------------
