----------------
Eooo------------
----------------
----------------
------##H-------
----------------
---------E##----
----------------
E-----------TTTT
#--------------#
#--------------#
##ESSESSS------#
##-------------#
##--------TTTTTT
