ESSSESSS--------
---------EETT---
----------------
ESSS--------TTTT
----------------
----------------
-----ESSE-------
----------------
ESSS--------Eooo
------------XXXX
-----------SSSSS
-------EoooSSSSS
------QXXXXSSSSS
----EE----------
