----------------
---E------------
----------------
----------------
----XEEE--------
----------TTT---
----------------
----------------
--------EETT----
----------------
--ESSSSSEE------
----------------
----------------
XXXE------------
