---###<>--####--
----##[]--####--
----##[]--####--
----##[]-E######
----##<>--####--
----##[]--####--
----##[]E-####--
----------####--
----------####--
---------TTT##--
-------H--------
ESSSEEMMMMMMMMMM
----------------
----------------
