----------------
----------------
------XXXX------
----------------
---XXXX---------
----------------
----------------
D###------#SSSSS
D---------------
#---------------
#------SSSS-----
#---------------
##--------------
##--XXXE--------
