#---T--MMMMSSSSS
D--------------S
D--------------S
####TTT##------S
####------------
X--------X------
----------------
----------------
----########----
-----------#----
-----------#----
XX----------####
XX--------------
XX--------------
