XXX#--------XXXX
XXX#--------XXXX
XXX####-----XXXX
XXX#------X-XXXX
XX----------####
##----------####
##----QSSSSSMMMM
##--------------
##--------------
###TTT----------
##--------------
----------------
-----TT##-------
----------------
