----------------
--------SSST----
----------------
--------------T-
----------------
----------------
-----X---#---E--
--T--X---#---X--
--#--X---#---X--
--#--X---#---X--
--#-E-----------
----------------
----------------
----XXXXQ-------
