##-----------TTT
##------------##
####SSSSS-----[]
##------------[]
----------------
---------##TT---
----------------
----------------
##------XMMMMMMM
##------------##
##------------##
####----------##
####-----------#
####-----------#
