----------------
---------####---
----------------
----------------
#MS?SQS##----Eoo
#------------XXX
#------------###
#--E---------#TT
----------------
----------------
-S--------------
----------------
----o---<>------
--------[]------
