<>##----------<>
[]##----------[]
[]##----------[]
XX##----ooXXXXXX
---#-#----------
---#------------
XX#-----------XX
XX####SSSS----XX
XX------------XX
XX------------##
XX----ESSS######
XX------------##
XX------------##
XXXXXXXE------##
