-----SS--oo-----
----------------
----------------
------E---oo----
----------------
----------------
-----XXXX?------
----------------
----------------
---XXXX--XXTT---
----------------
----------------
-------oo--TTTT-
----------------
