----------------
-----oo--Xo-----
----------------
----------------
--XX------------
--SSSSX---------
-----XX---------
-----ooX[]------
--------XX------
--------oo###---
-----------##---
ooXX-------#####
--XX-----------#
--XXXXX--------#
