--------###X----
--------###X----
------H####X----
----------------
---###o---------
---##-----------
XX###-----XXXXXX
----------[]----
-------ooSXX----
----------------
----oooo--------
----------------
----------------
--X-------------
