---#------------
###-----------XX
####XXXXXX----XX
XX------------<>
XX------------[]
##----oXXXXXXXXX
##------------<>
##------------[]
TTTT###X------[]
##----#SSSS---##
##------------##
##------------##
#TTT#-------####
#MMM###XXXX#####
