XX##TT-XX-----XX
oo##---XX-----XX
------T---oo----
----------------
----------------
-----TTXXX------
----------------
----------------
---TTTT--oooo---
----------------
----------------
-------oo--SSSS-
----------------
----------------
