-----[]--------<
-----XXSSS-----[
---------So----[
---------oo----#
---------------#
------------####
------------##--
---------XXSSS--
---------XX-----
------SSS-------
------SS--------
---###SS--------
---D#-----------
---D#-----------
