----------------
-----o--o--#----
----------------
----------------
-------------#--
-------------#--
-------------#--
--XXXE--o--#-#--
--X--#--#--#----
--#--#--#--#----
TT#--#--#--o----
----------------
----------------
########--------
