----XXXX----T###
ooooXXXXXooo####
XXXX---ooXXX-###
X------------TTT
X-------------##
#------X---S--SS
#---XXXXXooSooSS
#--#SSSSSSSSSSSS
##-#------------
##-#------------
#------Q-------<
#-T------------[
#--------------[
#------E-------[
