oooXXTTT-------<
XXXo---#SSS----[
---------------[
-----------o#--#
---------------#
---------------#
-------------###
---------------E
------XXXXXXXXXX
------XX--------
------XX--------
SSSSSSXX----SSSS
----------------
----------------
