ES-<-----------<
>--[SSSS-------[
]--[-----------[
]-XX-----XX##--#
]--X-----------#
]--X----------##
XX-X----------##
]--[----------[]
X--X---XXXXXXXXX
--##---[X-------
---#---[X-------
---#-SS[X-------
####---[X-----XX
####---[X---XXXX
