X--X------oS??SS
X--X----------SS
XX-X----------##
X--XX---------##
X--X----------##
#-TX----------##
#--X-----XX##-##
#--X----------<>
#T-X----------[]
#--####X------[]
X--#----------##
X-S#-----------#
X--D----SSS#---#
X--D-----------#
