----------------
-----S?---------
----------------
---H-----E------
S?MMMMMSSSSMMMMM
----------------
--H--------#----
S?S?SQS?SQSS?SQS
----------------
----------------
---------Q------
----------------
-----Q----------
-----------Q----
