SSSS--------SSSS
SSSSQS------SSSS
SSSS--------SSSS
SSSS--------SSSS
SS----S?SS?SSSSS
##------------##
##------------##
##HHH---H-----##
####MMMMMS?S####
----------------
----E--------E--
S?SQSSSSSS?SSSSS
----------------
----------------
