----------------
---------QSQS---
----------------
----------------
SSSSSSSSSSSS?SQS
----------------
----------------
-oooo-----------
----------------
----------------
-------QQ-------
----------------
----------------
-----------SSSQ-
