----------------
----------------
----S?QS--------
----------SQS---
----------------
----------------
--------S?QS----
----------------
--SSSSSS?S------
----------------
----------------
S?QQ------------
----------------
----------------
