----------------
----------------
-QS?SQSQS-------
----------------
----------------
S?S?SQSS?SQS?SQS
----------------
----------------
-SSSS-----------
----------------
----------------
-------QS-------
----------------
----------------
