-----------SSSQ-
----------------
----------------
-S?S?SSQS-------
----------------
----------------
<><>--------SSSS
[][]--------SSSS
[]XXXXQ-----SSSS
###?--------####
##------------##
#D-----QS?#---D#
#D------------D#
###Q--------####
