SSMMMSSS-----[]X
S----SSSQS--X[]X
S--H#SSSE--####-
S-MMMSSSQS----##
>-------------##
]-------------D#
]-------------D#
>-[---------####
]-[-----####----
XXXS?SQS--##TTTT
----------------
---------------E
-S?S?SQSQ----E<>
------------<>[]
