----------------
SSSSSQSQ--------
---------QSQS---
----------------
oooo--------S?SQ
----------------
----------------
-----S?QS-------
----------------
SSSS--------<>XX
------------[]XX
-----------X[]XX
-------EooXX[]XX
------SXXXXXXXXX
