------TTT-------
---D###--TQS----
---D][]---SSSS--
-TTT][]---SSSS--
---#XXXX--SSSS--
----SSSS--[][]--
----SSSS--[][]--
----SSSS-QXXXXXX
----SS##--####--
----SS##--####--
----SSTTT-####--
----------####--
----------####--
---------TTT##--
