----------TTTTTT
-------####-----
-------TTTT-----
---------------#
-ESQS--------###
SS----------SSSQ
----------------
------<>QS------
S?S?SQ[]--------
----------------
------------####
----------------
--------S?SQTTTT
----------------
