----------------
--------SSS-----
----------------
----------------
S?S---------SSSS
----------------
------------S?SQ
ooSS------------
----------------
--XXXXXSSS------
----------------
----------------
------------S?SQ
XXQS------------
