######------SSSS
####--------SSSS
####--------SSSS
##----###S?SSSSS
<>------------<>
[]------------[]
<>###---X-----[]
[]#D--------SS[]
[]#D--------SSSS
[]###SS-----SSSS
<>QS--------SSSS
[]------------SS
[]-----S?QS---SS
[]------------SS
