----------------
---E------------
-E<>Q-----------
----------------
----------------
####------------
####------------
####--QSQS------
####------------
##-------------#
SS----------TTTT
SS-------------#
SS-------------#
SSSSSSSSSSS-----
