-------Q--------
----------------
---------QSSSSSS
----------------
------E?QS------
----------------
---QSQS---------
--------------E-
SSSS--------SSSS
----------------
---------ESQS---
----------------
------S??S------
----------------
