--------------------------------------------------------------------------------------------------------------------------------------------
--------------------------------------------------------------------------------------------------------------------------------------------
--------------------------------------------------------------------------------------------------------------------------------------------
--------------------------------------------------------------------------------------------------------------------------------------------
--------------------------------------------------------------------------------------------------------------------------------------------
------------------------------------------------------------------------------------------#--------####---------------------------##--------
--------------------------------------------------------------------------------------------------------------------------------------------
--------------------------------------------------------------------------------------------------------------------------------------------
--------------------------------------------------------------------------------------------------------------------------------------#-----
----------------------------------#--------------------------------------------------#--------------#------------------------------------###
----------------------------#---------------------------------------------------------------------------------------------------------#-----
-------------##-------------#---------------------------------------------------------------------------------------------------------------
-------------#--------------#-----------------------------------------------------------------------------#---------------#-----------#-----
--#-###########-------------##########-##############################---###--######-################################################--######
