--------------------------------------------------------------------------------------------------------------------------------------------
--------------------------------------------------------------------------------------------------------------------------------------------
--------------------------------------------------------------------------------------------------------------------------------------------
--------------------------------------------------------------------------------------------------------------------------------------------
--------------------------------------------------------------------------------------------------------------------------------------------
-----#------------------#-------------------#-----------------------------------------------------------------------------------------------
--------------------------------------------------------------------------------------------------------------------------------------------
--------------------------------------------------------------------------------------------------------------------------------------------
--------------------------------------------------------------------------------------------------------------------------------------------
-----#----------#-------------------------##--#--------------#-------#--------------#-----------------------------------#-#-----------------
----------------------------------#---------------------------------------------------------------------------------------------------------
-----------------#----------------##-----------##-------------------------------------------------------------------------------------------
-----------------##---------------##-----------##---------------------#-----------------------------------------------------------#---------
##--#####################-###-##-#########-----####################################-#########--###-#################----####################
