--------------------------------------------------------------------------------------------------------------------------------------------
--------------------------------------------------------------------------------------------------------------------------------------------
--------------------------------------------------------------------------------------------------------------------------------------------
--------------------------------------------------------------------------------------------------------------------------------------------
--------------------------------------------------------------------------------------------------------------------------------------------
---------------#---------------------------------------------------------------------#------------------------------------------------------
--------------------------------------------------------------------------------------------------------------------------------------------
--------------------------------------------------------------------------------------------------------------------------------------------
-------------------------------------------------------------------------------------------------------------#------------------------------
-----------------------------------------------------------####----#----------------------------------#-#-----------------#-----------------
------------#-------------------------------------------------------------------------------------------------------------------------------
-----------##-------------------------------------------------------------------------------------------------------------------------------
-----------##--------------------------------------------------------------------------------------------#----------------------------------
#-----######################-#############--------------##############--#-#------##-###-#########################---------------############
