--------------------------------------------------------------------------------------------------------------------------------------------
--------------------------------------------------------------------------------------------------------------------------------------------
--------------------------------------------------------------------------------------------------------------------------------------------
--------------------------------------------------------------------------------------------------------------------------------------------
--------------------------------------------------------------------------------------------------------------------------------------------
------------#-------------------------------------------##-----------#--------------------------------###---------------------#-------------
--------------------------------------------------------------------------------------------------------------------------------------------
--------------------------------------------------------------------------------------------------------------------------------------------
--------------------------------------------------------------------------------------------------------------------------------------------
-------------------------------###----------#---#-------------------##----------------------------#-------------------------------------##--
------#-------------------------------------------------------------------------------------------------------------------------------------
------#-------------------------------------------------------------------------------------------------------------------------------------
------#----------------------------------------------#--------------------------------------------------------------------------------------
#-----#---###-#-###---###############################################################-#####-####################------------#-#######-######
