--------------------------------------------------------------------------------------------------------------------------------------------
--------------------------------------------------------------------------------------------------------------------------------------------
--------------------------------------------------------------------------------------------------------------------------------------------
--------------------------------------------------------------------------------------------------------------------------------------------
--------------------------------------------------------------------------------------------------------------------------------------------
--------------------###-----------------##------------------------------------------#-----------#-------------------------------------------
--------------------------------------------------------------------------------------------------------------------------------------------
--------------------------------------------------------------------------------------------------------------------------------------------
--------------------------------------------------------------------------------------------------------------------------------------------
------###--------------#--#-------#-----------------------------------------------#------------#####------####------------------------------
----------------------------------------------------------------------------#-----------------------------------------#--------------#------
-----#----------------------------------------------------------------------------------------------------------------#--------------#------
----------------------------------------------------------------------------------------------------------------------#--------------#------
###--#------#---##########################--------------##############--################################--------##############----#-#######-
