--------------------------------------------------------------------------------------------------------------------------------------------
--------------------------------------------------------------------------------------------------------------------------------------------
--------------------------------------------------------------------------------------------------------------------------------------------
--------------------------------------------------------------------------------------------------------------------------------------------
--------------------------------------------------------------------------------------------------------------------------------------------
--------------------------------------------------------------------------#-----------------------------------------------------------------
--------------------------------------------------------------------------------------------------------------------------------------------
--------------------------------------------------------------------------------------------------------------------------------------------
--------------------------------------------------------------------------------------------------------------------------------------------
---------------------------#----------------###-----------------------------#-#-------------------------#-#---------------------------------
--------------------------------------------------------#--#-------------------------------------------------------##-----------------------
--------------------------------------------------------#----------------------------------------------------------#------------------------
---------------------------------#----------------------#--#-------------------------------------------------------#------------------------
#############--###########################--#####-###---##-####################------#############--############--------------##############
