--------------------------------------------------------------------------------------------------------------------------------------------
--------------------------------------------------------------------------------------------------------------------------------------------
--------------------------------------------------------------------------------------------------------------------------------------------
--------------------------------------------------------------------------------------------------------------------------------------------
--------------------------------------------------------------------------------------------------------------------------------------------
##---------------------------------------------------------------------#--------------------------------#-----------------------------------
--------------------------------------------------------------------------------------------------------------------------------------------
--------------------------------------------------------------------------------------------------------------------------------------------
------#-------------------------------------------------------------------------------------------------------------------------------------
-----##------------###------------------------------------#-----------##-##-----#-----------------------------------------------------------
--------------------------------------------------------------------------------------------------------------------------------------------
-----------------------------------#--------------------------------------------------------------------------------------------------------
-----------------------------------##------------------------------------------------#------------------------------------------------------
#####----#--#################-###########-#######################-----############--##############------------------#-#-####################
