###D--------####
###D--------####
####TTT-----####
####------#-####
#D----------####
##----------####
##----T#########
##--------------
#D--------------
##TTTT----------
##--------------
----------------
-----TTTT-------
----------------
