--------##------
--------##TTT---
TTTT--------TTTT
----------------
----------------
---######-------
----------------
--------###T----
----------------
########----TTTT
----------------
----------------
-----####-------
----------------
