##-----------###
##------------D#
#########-----D#
##------------D#
----------------
---------####---
----------------
----------------
##------########
##------------##
##------------##
####----------##
####-----------#
####-----------#
