----------------
---####---------
----------------
----------------
D#-----##TT---##
D#------------##
##------------##
######----######
##------------##
##------------##
#-----####-----#
---------###T---
----------------
----------------
