----------------
---------####---
----------------
----------------
##TTTTT##----###
#------------###
#------------###
#--H---------###
----------------
----------------
-T--------------
----------------
----#---D#------
--------D#------
