----##----------
----##----------
######-------###
------------##--
------####--##--
------------##--
------------##--
----------####--
----------------
---H---D--------
MMMMM###TTTT####
----------------
----------------
-------##-------
