----####--####--
----####--####--
----D###-T######
----D###--####--
----####--####--
----####T-####--
----------####--
----------####--
---------T####--
-------H--------
----------------
---####--TTT----
---####---####--
-######---####--
