----------------
----------------
------TTT-------
----------------
----------------
----TTT#--------
----------TTT---
----------------
----------------
--------TTTT----
----------------
--########------
----------------
----------------
