########--------
---------TTTT---
----------------
####--------TTTT
----------------
----------------
-----TTT#-------
----------------
####--------####
------------####
-----------SSSSS
-------####SSSSS
------#####SSSSS
----#H----------
