----------------
---------EHH#---
----------------
----------------
TTMMMM#########H
----------------
----------------
-H###-----------
----------------
----------------
-------EE-------
----------------
----------------
-----------Eooo-
