---H##E---------
----------------
----------------
Eoo###E---------
----------------
------TTTT------
----------------
---------TT##---
----------------
##H#--------####
-----H----------
----TTH---------
----------------
------TTEE------
