----------------
----------------
----ES##--------
----------HH#---
----------------
----------------
--------EE##----
----------------
--MMMMMESS------
----------------
----------------
EE##------------
----------------
----------------
