-----------ESSS-
----------------
----------------
-EEEooEEE-------
----------------
----------------
EX##--------####
>X##--------####
]X##HHE-----D###
###T--------####
##------------##
#D-----EEE#---D#
#D------------D#
####--------####
