----------------
--------EEE-----
----------------
----------------
ESS---------Eooo
----------------
------------ESSS
####------------
----------------
--TTTTT###------
----------------
----------------
------------ESSS
#HEE------------
