----------------
####ESSE--------
---------EHH#---
----------------
####--------ESSS
----------------
----------------
-----EEEE-------
----------------
EETT--------####
------------####
-----------#####
-------Eoo######
------#XXXTTTTTT
