----------------
---E------------
-SSSE-----------
----------------
----------------
####------------
####------------
####--E##H------
####------------
##-------------#
##----------TTTT
##-------------#
##-------------#
####EEEEooo-----
