-----EE---------
----------------
---E-----E------
SSSEEEEEEESSH###
----------------
--E--------E----
ESSEEESSSSSS####
----------------
----------------
H##MMMH##H##Eooo
----------------
----H--------E--
###MMM######SSSS
----------------
