----------------
----------------
-E####H#H-------
----------------
----------------
EE####HESSS####H
----------------
----------------
-E###-----------
----------------
----------------
-------#H-------
----------------
----------------
