ESMMMEXX-----EXX
>---->XXEE--<>XX
]--H#]XXE--####-
]-MMM]XXSS----##
E-------------##
>-------------D#
]-------------D#
>-[---------####
]-[-----####----
XXX####H--##TTTT
----------------
---------------X
-EE####HE----EXX
------------<>XX
