EXXX--------EXXX
>XXXEE------>XXX
]XXX--------]XXX
####--------EXXX
##----ESSEoo>XXX
##------------##
##------------##
##HH#---H-----##
#####MMMMESSH###
----------------
----E--------E--
ESSSXXXXXEESSSSS
----------------
----------------
