######------EXXX
####-------->XXX
####--------]XXX
##----###Eoo]XXX
EE------------##
XX------------##
EX###---#-----##
>X##--------TT##
]X##--------####
]X##H##-----####
EX##--------####
>X------------##
]X-----ES#H---D#
]X------------D#
