----------------
-----E?---------
----------------
---H-----E------
EEMMMMMSSSSMMMMM
----------------
--H--------H----
EEESSSH####H####
----------------
----------------
---------E------
----------------
-----E----------
-----------E----
