SSSS--QSQSSSSSSS
SSSS--------SSSS
SSSS--------SSSS
SSSSQS------SSSS
SSSS--------SSSS
SSSS--------SSSS
SSSS----TTTTSSSS
XXXX--------SSSS
EXXX--------SSSS
>XXXS?STT---SSSS
]XXX--------####
]XXX--------####
]XXX-----S?#####
XXXX--------####
