----SSSS--------
----------TTQ---
---------D------
---------D------
--------ETTT----
----------------
--ES?SQSSQ------
----------------
----------------
XXXQ------------
----------------
----------------
------S?o-------
---------ESSSSS?
