-----E---E---E--
S?XXXXS?SSSSSSSS
----------------
----------------
---S------------
---S------------
-Q-S---E--------
S?S?SQSSS?SS?SQS
----------------
--------------#-
------------TTTT
--------------#-
----------------
---------Q------
