--E--------H----
S?SSSSSSSSMMMMMM
----------------
----------------
SSSSSSoooo######
----------------
----?--------?--
oooS??S?SQSSS??S
----------------
----------------
-----TT---------
----------------
---H-----H------
SSSMMMMMMMSSSSS?
