----------------
---------S?S----
----------------
S-----------SSSS
S--------------S
S--------------S
SoS?SQS?Q------S
SS-------------?
SS--------SSSSS?
SS-------------#
SS-------------#
SSoooo######---#
--SSSS####-----#
---------#TTTTTT
