---------S------
-----E---S---Q--
S?S?SSSSSSSSSSSS
----------------
----------------
---<------------
---[------------
-E-[---Q--------
####SSSSS?SSSSSS
----------------
----------------
---------QSS----
----------------
T-----------XXXX
