SSS>--------SSSS
SSS]--S?SS?SSSSS
SSS>--------SSSS
SSS]--------SSSS
SSS###------SSSS
SSS#--------SSSS
SSS#--------SSSS
---###o--oo#----
---####---<###--
-SS####---[###--
---#####--#>[]--
----####--#][]--
----####--#][]--
----####-TTXXXXX
