---------S?SQ---
----------------
----------------
S?S?S?S?SSSSSSSS
----------------
----E--------E--
S?SSSSS?SQS?SSSS
----------------
----------------
-----TQ---------
----------------
---H-----E------
S?MMMMXXXXSSSSSS
----------------
