----------------
------ESQQ------
----------------
---S??S---------
--------------Q-
SSSQ--------####
----------------
---------ETTT---
----------------
------S??S------
----------------
---?SQS---------
----------------
----------------
