----SSSS--[SSS--
----SSSS--[SSS--
----QS?SE-[SSS--
----------####--
----------####--
---------TTT##--
-------E--------
S?SQSSSSMMMMMMMM
--------------#-
------------TTTT
--------------#-
----------------
---------E------
---------E------
