----------------
---------QQQSSSS
----------------
------QS?E------
----------------
---oSQS---------
--------------E-
XXXX--------SSSS
----------------
--------B##SS---
--------b-------
------ESX#------
----------------
---XXXX---------
