----------------
----------------
S?S?TTT---------
----------------
------TTQS------
----------------
---------S?TT---
----------------
S?S?--------TTTT
-----E----------
----QSS---------
----------------
------ES?S------
----------------
