----------------
----------------
----------------
----------------
----------------
----------------
-------------XXX
----------------
----------------
-----EE-E-------
--XXXXXXXXXXXX--
----------------
----------------
XX--------------
