----------------
----------------
----------------
----------------
----------------
----------------
--------E-------
-------<>-------
-------[]-------
SS-----XX-------
---------------E
----------B---<>
----------b---[]
XXX---XXXXXXXXXX
