----------------
----------------
----------------
----------------
----------------
----------------
----------------
----------------
--o-----E--o----
-------<>-------
-------[]-------
-------[]-------
-------[]-------
XXXXXXXXXXXXXXXX
