----------------
----------------
----------------
----------------
----------------
------?SSS------
----------------
------------E---
----E------<>---
---<>---E--[]---
---[]--<>--[]---
---[]--[]--[]---
E--[]--[]--[]---
XXXXXXXXXXXXXXXX
