----------------
----------------
SSSSSSSSSSSSSSSS
----------------
----------------
----------------
----------------
----------------
----------------
----------------
----E-----SS----
---<>-----SS----
-E-[]-----SS----
XXXXXXXX--XX--XX
