----------------
----------------
----------------
----------------
----------------
---------SSS----
----------------
----------------
----------------
Q-----S---------
----------------
----------------
------------EE-E
XXXXXXXXXXXXXXXX
