----------------
----------------
oo--------------
----E--E--------
---XXXXXXX------
----------------
-------------oo-
----------------
XXX-------------
----------------
----------------
----------------
----------------
-------------XXX
