----------------
----------------
----------------
----------------
----------------
------------SSSS
----------------
----------------
-------------E--
------E----SSSSS
-----<>---------
-----[]---------
-----[]---------
XX--XXXXXXXXXXXX
