----------------
----------------
----------------
----------------
----------------
----------------
----------------
-X--------------
XX--oo------o---
XX--------------
XX--------------
XX--------------
XX--------------
XXXXXXXXXXX---XX
