----------------
----------------
----------------
----------------
----------------
-------SS---SS--
----------------
----------------
-----SS---------
-----------SSS--
---E------------
--<>------------
--[]------------
XXXXXXXX-X-XXXXX
