----------------
----------------
----------------
----------------
----------------
----------------
----------------
----------------
----------------
----------------
----------------
----------------
--E-E-----------
XXXXXXX-X-XX-XX-
