----------------
----------------
----------------
----------------
-------oooo-----
-------XXXX-----
----------------
----------------
----------------
----------------
--XXX-?---------
----------------
----------------
X-----XXXXX-XXXX
