----------------
----------------
----------------
----------------
----------------
----------------
----------------
-------------XSS
------------XXX-
-----------XXXX-
----------XXXXX-
---------XXXXXX-
--------XXXXXXX-
X-XXXXXXXXXXXX--
