----------------
----------------
----------------
----------------
----------------
----------------
----------------
----------------
----------------
QQQQ------------
-------B-----E--
E------b--------
----------------
XXXXXXXXXXXXXXXX
