----------------
----------------
SSSSSSSSSS------
----------------
------------XXX-
----------------
----------------
----------------
----------------
--------XXX-----
-------EXXX-XXX-
-----EXXXXX-----
-----XXXXXX-----
XXXXXXXXXX------
