----------------
----------------
S-----SSSSSSSSSS
S---------------
S---------------
S---------------
S---------------
S---------------
S---------------
S---------------
S---------------
S---------------
S---------------
XXXXXXXXXXX--XX-
