----------------
----------------
----------------
----------------
----------------
----------------
--XSSS----------
-XXX------------
XXXS------------
XXXX------------
XXXX-SSS-------<
XXXX-----------[
XXXX-----------[
XXXXXX---XXXXXXX
