----------------
----------------
----------------
----------------
----------------
----------------
----------------
----------------
----------------
----------------
----------------
----------------
-----E----EE-E--
XXXXXXXXXXXXXXXX
