----------------
----------------
----------------
----------------
----------------
---oo-----------
-----------XXX--
----------------
----------------
XXX--XXXX-------
----------------
----------------
----------------
------------XXXX
