----------------
----------------
----------------
-----oo---------
----------------
-------XXXX-----
----------------
----------------
XXX-------------
----------------
----------------
----------------
----------------
-----------XXXXX
