----------------
----------------
----------------
----------------
----------------
---o-o----XXX---
----------------
----------------
---XXXX---------
--------XXX-XXX-
----------------
XXX-------------
----------------
----------------
