----------------
----------------
----------------
----------------
----------------
----------------
----------------
----------------
----------------
----------------
----------------
----------------
E-------EE-E----
XXXXXXXXXXXXXXXX
