----------------
----------------
S-----SSSSSSSSSS
S---------------
S---------------
S---------------
S---------------
S---------------
S---------------
S---------QQQQQ-
S---------------
S---------------
S-------------EE
XXXXXXXXXXXXXXXX
