----------------
----------------
----------------
----------------
----------------
----------------
----------------
E---------------
>---------------
]---------------
]---------------
]---------------
]--------EE-E--E
XXXXXXXXXXXXXXXX
