----------------
----------------
----------------
----------------
----------------
-----SSS--------
----------------
----------------
----------------
----XXXXX-------
----X-----------
----X-----------
----X-----------
XXXXXXX----XXXXX
