----------------
----------------
----------------
----------------
----------------
------Q---------
----------------
----------------
----------------
Q---S?SQS-------
----------------
------------<>--
-----E------[]--
XXXXXXXXXXXXXXXX
