----------------
----------------
----------------
----------------
----------------
----------------
----------------
-o------XX------
--E-----XX------
SSSS----XX------
-------XXX------
---E---XXX------
-------XXX------
XXXXXXXXXX---XXX
