----------------
----------------
----------------
----------------
----------------
SSSS------------
----------------
----------------
E-------------SS
SSSS------------
------X----B----
------X----b----
------X----B----
XXXXXXXXXXXXXXXX
