----------------
----------------
SSSSSSSSS-------
----------------
-----------XXX--
--QQ------------
----------------
----------------
---------------S
--QQ--QQQ-------
----------------
----------------
----------------
XXXXXXXXX------X
