----------------
----------------
----------------
----------------
----------------
--XXoo----XX----
----------------
----------------
----------------
XX----XX-----XX-
----------------
----------------
----------------
----------------
