----------------
----------------
----------------
----------------
----------------
-----SSSS-------
----------------
----------------
-X--------------
EX---S-----X----
XX---------X----
XX---------XX---
XX----EE---XX---
XXXXXXXXXXXXXXXX
