----------------
----------------
----------------
----------------
----------------
----------S-----
----------------
----------------
--ooo-----------
E---------S-----
>---------------
]---------------
]---------------
XXXXXXXXXXXXXXXX
