----------------
----------------
----------------
----------------
----oo----------
---XXXX---------
--------o----E--
-------XXX------
----------------
----------------
-------o--------
XXX---XXXXX-----
----------------
---------------X
