----------------
----------------
----------------
----------------
--------oo--oo--
oo--------------
----------------
----------------
-XXX------------
---------XXX----
----------------
-------------XXX
----------------
----------------
