----------------
----------------
----------------
----------------
E---------------
QS--SQS---------
----------------
----------------
----------------
QS--S?S--------S
------------E--E
----------------
---E------------
XXXXXXXXXXXXXXXX
