----------------
----------------
----------------
----------------
----------------
----------------
----------------
----------------
----------------
----------------
---------------X
----------B----X
--EE-E----b----X
XXXXXXXXXXXXX--X
