----------------
----------------
----------------
----------------
----------------
QQQ-----------SS
----------------
----------------
----------------
QQQ----------S--
----------------
----------------
----E-E--E--EE-E
XXXXXXXXXXXXXXXX
