----------------
----------------
----------------
----------------
----------------
----------------
----------------
----------------
----------------
----------------
-------------XXX
----------------
----------------
XXXXXXXXXXX-----
