----------------
----------------
----------------
----------------
----------------
--------SSQSSS?S
----------------
----------------
-E--------------
<>------SSSSSSSS
----------------
----------------
----------------
XXXXXXXXXXXXXXXX
