----------------
----------------
----------------
----------------
----------------
SS--------SSSSS-
----------------
----------------
----E-----------
---<>---QQQQ--QQ
---[]-----------
---[]-----------
---[]-------E-EE
XXXXXXXXXXXXXXXX
