----------------
----------------
----------------
----------------
----------------
--XXX-----------
-XXXX-----------
XXXXX-----------
XXXXX-----------
XXXXX-----------
XXXXX-----------
XXXXX-----------
XXXXX-------XX--
XXXXXXXXXXXXXXXX
