----------------
----------------
----------------
----o-----------
----------------
--SSS-------E---
-----------<>---
-----------[]---
--------E--XXX--
---S---<>-------
-------[]------E
-------[]-----<>
----E--[]-----[]
XXXXXXXXXXXXXXXX
