----------------
----------------
----------------
----------------
----------------
----------------
----------------
----------------
---------o------
----------------
----------------
----------------
----E---------EE
XX-XXXXXXXXXXXXX
