----------------
----------------
----------------
----------------
----------------
SS---?----------
----------------
----------------
----------------
----------E-----
---E-----<>-----
---------[]-----
---------[]E----
XXXXXXXXXXXXXXXX
