----------------
----------------
----------------
----------------
----------------
----------------
----------------
----------------
----------------
----------------
----------------
---------------E
----------------
XXXX---XXXXXXXXX
