----------------
----------------
----------------
----------------
----------------
----------------
----------------
----------------
----------------
---------<>-----
---------[]-----
---------[]-----
-----E-E-[]-----
XXXXXXXXXXXXXXXX
