----------------
----------------
----------------
----------------
-----Eooo-------
-----XXXXX------
----------------
----------------
--------------XX
---XXXXXXXX-----
----------------
------------o---
X----------XXX--
----------------
