----------------
----------------
----------------
----------------
--E-------------
SSSSSSSS---SSSQ-
----------------
----------------
----------------
--------------S-
----------------
----------------
---------------E
XXXXXX---XXXXXXX
