----------------
----------------
-------SSSS-----
----------------
--------?-------
-------S??------
------------XXX-
----------------
----------------
---XXX-SSSS-----
XX--------------
XX--------------
XX--------------
X------XXXX-----
