----------------
----------------
----------------
----------------
----------------
----------------
----------------
----------------
-E--------------
<>--------------
[]-----------E--
[]----------<>--
[]--------E-[]--
XXX---XXXXXXXXXX
