----------------
---T------------
----------------
----------------
----T###--------
----------TTT---
----------------
----------------
--------TTTT----
----------------
--########------
----------------
----------------
####------------
