---#####--####--
----####--####--
----####--####--
----####-T######
----####--####--
----####--####--
----#####-####--
----------####--
----------####--
---------TTT##--
-------H--------
####TTMMMMMMMMMM
----------------
----------------
