----####--####--
----####--####--
----####-#######
----####--####--
----####--####--
----####T-####--
----------####--
----------####--
---------T####--
-------H--------
----------------
---####--TTX----
---####---#XXX--
-######---#XXX--
