----------------
----------------
------TTT-------
----------------
----------------
----T###--------
----------TTT---
----------------
----------------
--------##TT----
----------------
--########------
----------------
----------------
