----------------
---------###----
----------------
#-----------####
#--------------#
#--------------#
#########------#
##-------------#
##--------######
#D-------------#
#D-------------#
TTTT########--D#
--TTT####T----D#
---------TTTTTTT
