----##----------
----##----------
######-------###
------------##--
------####--##--
------------##--
------------##--
----------####--
----------------
---H---#--------
MMMMM###########
----------------
----------------
-------##-------
