---------------#
o-----------####
X---ooooooo#####
S-------------##
S-------------##
Sooo----------##
##oooooo------##
##SSSSSSooo#--##
##------------##
##-----------###
##-----------###
##-----------###
##oooooooooo####
D#SSSSXXSSSS####
