---------oo----#
---------------#
o-----------####
X---ooooooo#####
o-------------##
X-------------##
###S----------##
###Soooo------##
###SSXXXXooT--##
##------------##
##-----------###
##-----------###
##-----------###
###oooooooo#####
