####o---------oo
#-------------SS
#-------------SS
####-------oooSS
####SSSSSoooMM##
#--------------#
#--------------#
#---oooo-------#
#--------------#
----------------
#MMMMSSSSSSSMMM#
#--------------#
#H-----------H##
#MMMMoooooooMMM#
