oo##-----------o
---------##SS--S
SS-------##---XX
SS----#####---X-
oo------------X-
SSTTT---------#-
--------------##
---TToo-------##
-----SS-------##
-----ooTTT----##
----------------
----------------
---------TT##---
----------------
