----------o-----
----------------
----------------
##----------####
##----------####
#####oooo---####
oooo------SS####
SSSS------SS##--
####T-TTooSS##--
####------oo##--
##-----------###
##--oo-------###
##-----------D##
##-----------D##
