oo-----------###
XX-----------###
-######oo--####-
-####------####-
-####------####-
-SSTT----SSS###-
----------------
----------------
-------ooooo###-
-oo##-----------
----------------
----------------
----oooo--------
----------------
