ooSSSSST----oooo
------------SSSS
------------####
------oTTTT#####
------##--------
------##--------
ooooo###----TTTT
----------------
---------TTTT---
----------------
------####------
------##--------
---#####--------
---##-----------
