#------#D##----#
##-----####--T-#
##H----####----#
##----##-------#
##TT--SS-----T-#
------SS-------#
-----oSS-------#
-------o----oo--
---oS--S--------
-------#--------
#----##-------##
#TT--##----#####
#---H##D------##
#----##D------##
