-ooo####T--#ooo-
-SSS#------#XXX-
-####------####-
-####----oo####-
##----------####
##----------####
####MMMMM---####
####------S#####
####------S###--
####T-TTToS###--
####------####--
##-----------###
##--oo-------###
##-----------D##
