####------------
####------------
####oooo--------
####XX-oo-------
----------------
----------------
--------XXXo----
----------------
o-------------##
#-------------##
###H-------H####
#MMMoooooooMMM##
#--------------#
#--------------#
