oooo----------SS
--------------SS
--------------SS
-----------oooSS
----ooooo-------
----------------
oooo----------XX
-------------XXX
-------------XXX
-----------S-###
-------ooooSHH##
-----o-SSSSS#-#-
----------------
----------------
