oo##T-----------
--##------------
--##TTT---------
-----oo---------
-----XXXoo------
--------XX------
--------ooo##---
-----------##---
oooo-------#####
--oo-----------#
--SS###--------#
-----##--------#
-----####o-----#
---------XX----#
