####------------
####Eooo--------
#---XXXXXoo#----
#-------oSS#####
#-----------####
#-------------##
#-------------##
#---Eooo------##
#---XXXXXoo#--##
##------TT######
#D----------####
#D-----------###
####oooTTT---###
####-----------#
