o---oooT-------#
X--------------#
----------------
#MMMoooTTTTMMMM#
#--------------#
#H-----------H##
oooooooooooMMMM#
----------------
----------------
#----##-------##
#TT--##----#####
#---H##-------##
#----##-------##
#--TT--######--#
