----------------
----------------
#####ooooooo####
#--------------#
o----o---------o
X--------------X
----------------
---o------------
----------------
##HHHoooo--#####
-####XXXX--#####
---------T-----#
---------------#
----------------
