----------------
-----o----------
----------------
----------------
----oooo--------
----------------
--------oooo----
#-------------oo
#-------------SS
#-------------##
X-----Hoooo#####
X--oMMM---------
X---------------
X---------------
