-------------###
-----------T-###
-------ooooHHH##
-----o-SSSS##-#-
----------------
----------------
####------------
####------------
#######o--------
oooXXX-oo-------
----------------
----------------
--------XXXo----
----------------
