-------##oo-----
---oHHH---------
---####---------
---#------------
####---------ooo
----------------
-----------Tooo-
-------oo##-----
-------####-----
----ooo#--------
ooooXXX#-------<
---------------[
---------------[
-------------SS[
