-------------<>X
XXXXooooo----[]X
X-----XXXE-EX[]X
X------------TTT
X-------------##
X-------------##
X-------------<>
X-------------[]
X-----XXXXXXXXXX
--------ooooSSSS
----oSSSXXXX----
ooX-------------
----------------
----------------
