SSSooSS---------
----------------
------SooT------
----------------
---------###X---
----------------
SSSX--------SSSS
-----o----------
----XXX---------
----------------
------ooSS------
----------------
---------SSSS---
----------------
