---------SSSo---
----------------
----------------
ooooooooSSSSSSSS
----------------
----X--------X--
XXXXXXXXXXXXXXXX
----------------
----------------
-----TX---------
----------------
---H-----E------
ooMMMMXXXXSSSSSS
----------------
