----------------
------Xooo------
----------------
---ooXX---------
--------------X-
SSSo--------XXXX
----------------
---------XXXX---
----------------
------XXXX------
----------------
---SSSS---------
----------------
----------------
