----------------
----------------
ooooXXX---------
----------------
------XXoo------
----------------
---------ooXX---
----------------
XXXX--------XXXX
-----E----------
----oXX---------
----------------
------oSSS------
----------------
