---------X------
-----E---X---X--
ooooSSSSooSSSSSS
----------------
----------------
---X------------
---X------------
-X-X---X--------
MMMMSSSSooSSSSSS
----------------
----------------
---------ooo----
----------------
#-----------XXXX
