XXXX--oSSSSSSSSS
XXXX--------SSSS
XXXX--------SSSS
XXXXoo------SSSS
XXXX--------XXXX
XXXX--------XXXX
XXXX----XXXXXXXX
XXXX--------XXXX
XXXX--------XXXX
XXXXXXXXX---XXXX
XXXX--------####
XXXX--------####
XXXX-----ooTTTTT
XXXX--------####
