----------------
---------QQQSSSS
----------------
------oooE------
----------------
---XSSS---------
--------------X-
XXXX--------XXXX
----------------
--------BXXoo---
--------b-------
------XSXX------
----------------
---XXXX---------
