--X--------H----
XXXXXXooooMMMMMM
----------------
----------------
SSSSSSXXXXMMMMMM
----------------
----?--------X--
oooS??SSSSXXXXXX
----------------
----------------
-----TT---------
----------------
---H-----H------
XXXMMMMMMMXXXXXX
