--------##------
--------##TTT---
XXTT--------TTTT
----------------
----------------
---SSQQQ#-------
----------------
--------###T----
----------------
SSMMMMMM----TTTT
----------------
----------------
-----MMMX-------
----------------
