####SSSS?SQM#MMM
####------------
####------------
####----E-------
--------#-------
--------#-------
--------#-T-----
----------------
----------------
MMMMTTTXXXXSSSSS
----------------
----------------
####----------SS
####----------SS
