----------------
##------XXXTTTTT
##------------SS
##------------SS
TTTT----------SS
###>-----------#
TTT]-----------#
XXXXXXSSSSS#---#
XXXXXXSSSSS----#
####----------##
#D-------------D
#D-------------D
#####---XXX#####
######XXXXX#####
