----------------
----------------
TTTTTTTTSSMMMMMM
----------------
----------------
SQSSSSXXSSS#####
----------------
----------------
SSXXXXTTTTTMMM##
S-------------##
#-------------##
###QQ?TTMMMMMM##
##--------------
##--------------
