##--------------
##TTT-----------
----------------
---MMME---------
----------------
------XXXX------
----------------
---------H##T---
----------------
XXTT--------####
----------------
---###H---------
----------------
------TT##------
