----o----XXXT---
----------------
----------------
--T###-----T###-
--------D-------
--------D-------
------#TTT------
----------------
----------------
--#SSS----<ooo--
----------------
----------------
TTTo-------oTTTT
----------------
