----------------
------o##T------
----------------
---XXSS---------
--------------X-
TTT#--------####
----------------
---------#TTT---
----------------
------XXHH------
----------------
---QQQQ---------
----------------
----------------
