----------------
---------###SSSS
----------------
------EQQ#------
----------------
---T###---------
--------------?-
TTTT--------SS??
----------------
--------#TT??---
--------#-------
------T###------
----------------
---TTTT---------
