----------------
----------------
XX##TTT---------
----------------
------##XX------
----------------
---------XXTT---
----------------
XX##--------####
-----E----------
----oXX---------
----------------
------o###------
----------------
