----XXXX--#XXX--
----XXXX--#XXX--
----SSSST-#XXX--
----------####--
----------####--
---------TTT##--
-------E--------
XXXXXXXXMMMMMMMM
--------------#-
------------TTTT
--------------#-
----------------
---------X------
---------X------
