----------------
----------------
----####--------
----------###---
----------------
----------------
--------####----
----------------
--MMMMM###------
----------------
----------------
TT##------------
----------------
----------------
