----------------
---------####---
----------------
----------------
##MMMM##########
----------------
----------------
-####-----------
----------------
----------------
-------T#-------
----------------
----------------
-----------#TT#-
