####--------####
######------####
####--------####
####--------####
##----##########
##------------##
##------------##
##HHH---H-----##
####MMMMM#######
----------------
----#--------H--
###########MMMMM
----------------
----------------
