##MMM###-----###
#----#####--####
#--H#####--####-
#-MMM#####----##
#-------------##
#-------------D#
#-------------D#
>-[---------####
]-[-----####----
XXX#####--##TTTT
----------------
---------------#
-TT######----###
------------####
