----------------
----------------
MMMMMS?SQ?SQMMMM
#--------------#
D----#---------E
#--------------X
----------------
---#------------
----------------
##HHHH###--#####
-####MMM#--#####
---------T-----#
---------------#
----------------
