<>-----------###
[]-----------###
-<>####M#--<###-
-[]##------[###-
-XX#D------X###-
-SQQS----SS?###-
----------------
----------------
-------#Tooo###-
-S??S-----------
----------------
----------------
----E?QT--------
----------------
