-<>XD###T--#X<>-
-[]XD------#X[]-
-####------####-
-####----M#####-
##----------####
##----------####
####MMMMM---####
XX<>------B###MM
XX[]------b###--
XX[]H-H##SX###--
####------####--
##-----------###
#D--#H-------###
#D-----------D##
