X--SS--ESo??T--#
X------SSSS----#
XX-----SHHH--T-#
##H----S###----#
##----<>-------#
##TT--[]-----T-#
------XX-------#
-----HT#-------#
-------#----TT--
---##--#--------
-------#--------
------------T---
----#T---#H-----
----------------
