####------------
####------------
####?SQ#--------
#TTTXX-oT-------
----------------
----------------
--------####----
----------------
#-------------##
#-------------##
###H-------H####
#MMMS?SQ?SQMMM##
#--------------#
#--------------#
