-------------###
-----------T-###
-------EoooHHH##
-----#-XXXX##-#-
----------------
----------------
D##>------------
D##]------------
T##XXXX#--------
MM#XXX-oT-------
----------------
----------------
--------###T----
----------------
