-------####-----
---#HHH---------
---D###---------
---D------------
####---------#TT
----------------
-----------T##H-
-------H###-----
-------####-----
----##H#--------
QQ?SMMM#-------<
---------------[
---------------[
-------------SS[
