M#<>T-----------
--[]------------
--XXTTT---------
-----[]---------
-----XXS<>------
--------[]------
--------#T#<>---
-----------[]---
#T#T-------XXXXX
--#D-----------#
--#T###--------#
-----##--------#
-----####E-----D
---------QS----D
