H---?SQT-------B
#--------------b
----------------
#MMM?SQMMMMXXXXX
#--------------#
#H-----------H##
S?SQ?SQS?SQMMMM#
----------------
----------------
#----##-------##
#TT--##----#####
#---H##-------##
#----##-------##
#--TT--######--#
