##-----------XSS
-####?SQH--#XXX-
-###D------#XXS-
-####------b##D-
-####----SSX##D-
#D----------####
#D----------####
#TTTS?SQH---####
####------######
####------####--
####H-H#######--
####------####--
#D-----------###
#D--TT-------###
