----------#-----
----------------
----------------
<>----------####
[]----------####
XXXXX?SQ#---####
XX<>------<>####
XX[]------[]#D--
####H-H#XXXX##--
####------#T##--
##-----------###
##--#H-------###
#D-----------D##
#D-----------D##
