M#MMMMMT----<>XX
------------[]XX
------------H###
------#MMMMMMMM#
------B#--------
------b#--------
#T?SQSX#----####
----------------
---------TTTT---
----------------
------####------
------##--------
---#####--------
---##-----------
