MMQS-----------#
---------<>TT--#
H#-------[]---XS
MM----EXXXX---X-
#D------------X-
#TMMM---------#-
--------------##
---TT<>-------##
-----[]-------##
-----#TTTT----TT
----------------
----------------
---------####---
----------------
