---------T#----#
---------------#
#-----------H###
D---S?SQSM######
D-------------##
#-------------##
###T----------D#
###HH##H------##
#####MMMMM#T--##
#D------------##
<>-----------###
[]-----------###
[]-----------###
XXS?SQ?SQ#TH####
