---------------#
#-----------####
D---#TS?SQS#####
B-------------##
b-------------##
XST#----------##
<>H###<>------##
[]MMM#[]?SQ#--##
XX------------##
E<-----------###
>[-----------###
][-----------###
][Eooo<>Eooo####
XXXXXX[]XXXX####
