D####---------<>
D-------------[]
#-------------H#
####-------#MMMM
####SSS?SE?QMM##
#--------------#
#--------------#
D---oooo-------#
#--------------#
----------------
#MMMMSS?SSS?MMM#
#--------------#
#H-----------H##
#MMMMoooooooMMM#
