###H------------
#MMMEooo--------
#---XXXXX#H#----
#-------#MM#####
E-----------####
>-------------<>
]-------------[]
]---Eooo------[]
]---XXXXX#TE--[]
##------########
##----------####
##-----------###
#TTT?SQMMM---###
#MMM-----------#
