#------<<>#----#
##-----[[]#--T-#
##H----[XX#----#
##----SX-------#
##TT--<>-----T-#
------[]-------#
-----XXX-------#
-------<----<>--
---#E--[--------
-------#--------
#----##-------##
#TT--##----#####
#---H##D------##
#----##D------##
